,Duration,Epidemic,ep_high,ep_low,Rt
0,195,688,447,241,0.418
1,267.5,725,445,280,0.385
2,17,0,0,0,2
3,267.25,715,444,271,0.397
4,286.5,756,463,293,0.318
5,36,1,0,1,1.999
6,267.5,666,430,236,0.474
7,291.25,630,416,214,0.538
8,14.25,0,0,0,2
9,222.25,676,434,242,0.456
10,3,0,0,0,2
11,271.25,690,424,266,0.462
12,113,12,8,4,1.972
13,303.25,657,431,226,0.481
14,308.75,694,442,252,0.422
15,292,663,419,244,0.499
16,44.5,7,4,3,1.985
17,33,1,1,0,1.997
18,243,651,437,214,0.475
19,9,0,0,0,2
20,261.5,662,431,231,0.476
21,5.25,0,0,0,2
22,286.75,706,459,247,0.376
23,303.5,701,449,252,0.401
24,232.5,701,452,249,0.395
25,245.5,685,442,243,0.431
26,276.5,683,437,246,0.443
27,240.75,717,457,260,0.369
28,208,674,427,247,0.472
29,294.5,644,430,214,0.496
30,287,713,448,265,0.391
31,9.5,0,0,0,2
32,264,687,434,253,0.445
33,279.5,678,435,243,0.452
34,259.75,683,431,252,0.455
35,22.5,1,1,0,1.997
36,14.75,0,0,0,2
37,189.75,696,439,257,0.426
38,335.75,690,442,248,0.426
39,241.5,670,432,238,0.466
40,279.75,696,452,244,0.4
41,248.25,672,432,240,0.464
42,16,1,1,0,1.997
43,237.5,665,418,247,0.499
44,440.25,655,426,229,0.493
45,26,1,1,0,1.997
46,4.75,0,0,0,2
47,279.75,694,448,246,0.41
48,26.75,1,1,0,1.997
49,212.5,687,433,254,0.447
50,13.75,0,0,0,2
51,275.25,634,403,231,0.56
52,278,708,460,248,0.372
53,264.25,707,447,260,0.399
54,272.75,693,439,254,0.429
55,238,616,413,203,0.558
56,296,661,426,235,0.487
57,250.75,714,443,271,0.4
58,28.75,0,0,0,2
59,36.5,2,1,1,1.996
60,207,691,446,245,0.417
61,274,691,441,250,0.427
62,262.25,695,440,255,0.425
63,256.25,721,457,264,0.365
64,55.25,8,7,1,1.978
65,14.75,0,0,0,2
66,244.75,720,429,291,0.422
67,233.25,679,436,243,0.449
68,230.5,683,442,241,0.433
69,246.75,710,443,267,0.404
70,18.75,2,2,0,1.994
71,10.75,0,0,0,2
72,212.75,694,434,260,0.438
73,258.75,687,450,237,0.413
74,231.5,695,425,270,0.455
75,21,1,1,0,1.997
76,285.25,677,441,236,0.441
77,222.25,658,432,226,0.478
78,234.5,682,439,243,0.44
79,283.5,681,429,252,0.461
80,12,0,0,0,2
81,38.25,3,1,2,1.995
82,272.75,652,430,222,0.488
83,19.25,0,0,0,2
84,5.75,0,0,0,2
85,32,4,3,1,1.99
86,304.75,684,449,235,0.418
87,268.5,667,446,221,0.441
88,221.5,715,462,253,0.361
89,298.25,670,431,239,0.468
90,7.25,0,0,0,2
91,34.25,1,1,0,1.997
92,7,0,0,0,2
93,41.5,2,1,1,1.996
94,7.75,0,0,0,2
95,29,1,1,0,1.997
96,263.5,660,429,231,0.482
97,296.75,679,430,249,0.461
98,16.5,0,0,0,2
99,17.25,0,0,0,2
100,208.75,715,444,271,0.397
101,256.75,715,451,264,0.383
102,246.75,673,437,236,0.453
103,19,0,0,0,2
104,295,650,420,230,0.51
105,309,704,435,269,0.426
106,337,642,413,229,0.532
107,92.75,8,4,4,1.984
108,26.5,0,0,0,2
109,18.5,0,0,0,2
110,247.25,701,432,269,0.435
111,240.25,694,445,249,0.416
112,30,0,0,0,2
113,251.5,663,424,239,0.489
114,253.5,671,429,242,0.471
115,45.5,3,3,0,1.991
116,220.75,650,427,223,0.496
117,251.5,645,418,227,0.519
118,205.5,648,405,243,0.542
119,297.5,616,426,190,0.532
120,282.75,692,427,265,0.454
121,259.5,698,446,252,0.41
122,10,0,0,0,2
123,26.25,0,0,0,2
124,15.25,2,2,0,1.994
125,19.25,0,0,0,2
126,14.5,0,0,0,2
127,10.5,0,0,0,2
128,290.25,685,437,248,0.441
129,29.75,0,0,0,2
130,275.5,701,450,251,0.399
131,217.75,723,443,280,0.391
132,224.25,689,434,255,0.443
133,241,718,447,271,0.388
134,235.5,721,456,265,0.367
135,300.75,684,420,264,0.476
136,247.25,694,436,258,0.434
137,216,705,446,259,0.403
138,36.75,1,1,0,1.997
139,346.25,669,416,253,0.499
140,19.25,0,0,0,2
141,259.75,677,424,253,0.475
142,270.75,695,444,251,0.417
143,209.25,673,426,247,0.475
144,250.25,684,440,244,0.436
145,210,714,443,271,0.4
146,287.75,694,435,259,0.436
147,9.5,0,0,0,2
148,306,720,438,282,0.404
149,207,677,426,251,0.471
150,19.75,1,1,0,1.997
151,213.75,671,437,234,0.455
152,284,708,447,261,0.398
153,259,680,439,241,0.442
154,258.75,703,441,262,0.415
155,7,0,0,0,2
156,11,0,0,0,2
157,282.5,682,433,249,0.452
158,300.5,637,424,213,0.515
159,365.25,692,444,248,0.42
160,347,686,422,264,0.47
161,281.25,747,466,281,0.321
162,3.5,0,0,0,2
163,243.5,677,438,239,0.447
164,49,3,3,0,1.991
165,239.75,680,435,245,0.45
166,15.75,0,0,0,2
167,270.5,683,432,251,0.453
168,286.25,662,427,235,0.484
169,241.5,715,427,288,0.431
170,21,0,0,0,2
171,268.75,611,405,206,0.579
172,358.25,621,411,210,0.557
173,229,699,431,268,0.439
174,274.75,686,435,251,0.444
175,14.25,0,0,0,2
176,202,679,438,241,0.445
177,217.75,653,421,232,0.505
178,16.75,0,0,0,2
179,284,653,418,235,0.511
180,268.25,707,443,264,0.407
181,286.5,691,445,246,0.419
182,289.75,638,409,229,0.544
183,13.75,0,0,0,2
184,247.75,710,447,263,0.396
185,223.5,671,435,236,0.459
186,296.5,648,422,226,0.508
187,16,0,0,0,2
188,217.5,661,426,235,0.487
189,316.5,727,453,274,0.367
190,216.75,674,429,245,0.468
191,284,692,439,253,0.43
192,260.25,714,465,249,0.356
193,280.5,693,446,247,0.415
194,14.25,0,0,0,2
195,4.75,0,0,0,2
196,48.25,6,4,2,1.986
197,246.5,740,453,287,0.354
198,251,700,444,256,0.412
199,245.75,706,458,248,0.378
200,291.75,656,435,221,0.474
201,223.25,726,450,276,0.374
202,307.5,648,423,225,0.506
203,9.5,0,0,0,2
204,253.75,616,407,209,0.57
205,188.75,650,423,227,0.504
206,15,0,0,0,2
207,330.5,652,423,229,0.502
208,7.75,0,0,0,2
209,23.5,1,1,0,1.997
210,10.25,0,0,0,2
211,283.25,729,454,275,0.363
212,267.25,638,422,216,0.518
213,271.25,670,432,238,0.466
214,304.75,644,407,237,0.542
215,221.75,685,448,237,0.419
216,254.5,715,443,272,0.399
217,340.75,689,429,260,0.453
218,303,671,430,241,0.469
219,258,660,437,223,0.466
220,7.5,0,0,0,2
221,278.5,680,433,247,0.454
222,18,0,0,0,2
223,259,730,451,279,0.368
224,247.25,664,423,241,0.49
225,263.75,698,437,261,0.428
226,216.5,663,434,229,0.469
227,249.25,718,453,265,0.376
228,247,698,449,249,0.404
229,221.25,644,424,220,0.508
230,348,687,436,251,0.441
231,265.25,713,452,261,0.383
232,272.75,652,418,234,0.512
233,267,677,433,244,0.457
234,8.25,0,0,0,2
235,54.5,6,6,0,1.982
236,296.75,716,450,266,0.384
237,288.5,704,447,257,0.402
238,303.25,597,402,195,0.599
239,353.75,659,427,232,0.487
240,262,712,460,252,0.368
241,291.25,703,442,261,0.413
242,249.5,683,421,262,0.475
243,293,655,409,246,0.527
244,184.5,667,431,236,0.471
245,218,671,442,229,0.445
246,24.75,1,0,1,1.999
247,291,680,439,241,0.442
248,10.25,0,0,0,2
249,10,0,0,0,2
250,28.75,1,1,0,1.997
251,21.25,0,0,0,2
252,267.25,709,444,265,0.403
253,257.5,702,453,249,0.392
254,9,0,0,0,2
255,293.5,696,434,262,0.436
256,229,707,446,261,0.401
257,266.5,647,432,215,0.489
258,18.25,1,1,0,1.997
259,258,694,431,263,0.444
260,243.5,699,435,264,0.431
261,12.5,0,0,0,2
262,290.5,729,455,274,0.361
263,265.5,659,420,239,0.501
264,28.25,0,0,0,2
265,8,0,0,0,2
266,288,722,459,263,0.36
267,268.25,716,449,267,0.386
268,2.75,0,0,0,2
269,266.25,749,450,299,0.351
270,14.75,0,0,0,2
271,20.25,0,0,0,2
272,17.5,0,0,0,2
273,24.75,0,0,0,2
274,272.25,675,421,254,0.483
275,224.75,708,448,260,0.396
276,332,681,442,239,0.435
277,278,704,443,261,0.41
278,330.25,678,435,243,0.452
279,212.25,674,433,241,0.46
280,24.75,1,1,0,1.997
281,5.5,0,0,0,2
282,265.75,695,434,261,0.437
283,252.25,698,445,253,0.412
284,319.25,687,428,259,0.457
285,272.75,688,444,244,0.424
286,277.5,674,432,242,0.462
287,314.5,699,439,260,0.423
288,274.75,701,444,257,0.411
289,410.75,685,431,254,0.453
290,196.25,691,445,246,0.419
291,18.5,0,0,0,2
292,247,687,432,255,0.449
293,327.5,653,416,237,0.515
294,324.75,653,417,236,0.513
295,16.75,0,0,0,2
296,219.25,646,421,225,0.512
297,306.25,680,432,248,0.456
298,253.5,691,444,247,0.421
299,6.75,0,0,0,2
300,215.75,732,458,274,0.352
301,18,0,0,0,2
302,34.75,3,3,0,1.991
303,9.25,0,0,0,2
304,27.25,2,2,0,1.994
305,265.75,679,438,241,0.445
306,272.75,687,440,247,0.433
307,250.25,674,428,246,0.47
308,289,687,442,245,0.429
309,262,700,441,259,0.418
310,271.25,649,420,229,0.511
311,288.25,681,429,252,0.461
312,16,0,0,0,2
313,231.25,696,440,256,0.424
314,251.5,648,416,232,0.52
315,293.75,640,430,210,0.5
316,271.75,671,424,247,0.481
317,298,707,443,264,0.407
318,25,0,0,0,2
319,255,700,439,261,0.422
320,270.5,695,438,257,0.429
321,28.25,0,0,0,2
322,21.75,1,1,0,1.997
323,259.25,655,409,246,0.527
324,373.25,679,449,230,0.423
325,284.5,623,407,216,0.563
326,226,710,439,271,0.412
327,298.25,727,455,272,0.363
328,39.5,2,1,1,1.996
329,8.75,0,0,0,2
330,324.5,640,412,228,0.536
331,263,664,429,235,0.478
332,303.75,689,436,253,0.439
333,32,2,1,1,1.996
334,266,639,422,217,0.517
335,311.75,614,408,206,0.57
336,309.5,707,449,258,0.395
337,18.25,1,1,0,1.997
338,296.75,680,441,239,0.438
339,223,710,453,257,0.384
340,274.75,695,453,242,0.399
341,18,0,0,0,2
342,274,669,423,246,0.485
343,11,0,0,0,2
344,15,0,0,0,2
345,19.75,0,0,0,2
346,18.25,2,2,0,1.994
347,266,690,446,244,0.418
348,6,0,0,0,2
349,364.25,686,437,249,0.44
350,316.75,639,424,215,0.513
351,9.75,0,0,0,2
352,11.75,0,0,0,2
353,253.5,726,453,273,0.368
354,18,1,1,0,1.997
355,17.5,0,0,0,2
356,20.5,1,0,1,1.999
357,376.75,687,430,257,0.453
358,299,688,432,256,0.448
359,305.25,650,413,237,0.524
360,285.5,695,441,254,0.423
361,214.75,723,441,282,0.395
362,212.5,708,437,271,0.418
363,307.5,642,418,224,0.522
364,40.5,2,2,0,1.994
365,38.5,3,2,1,1.993
366,356,696,440,256,0.424
367,219.75,670,419,251,0.492
368,208.25,657,424,233,0.495
369,226.5,656,427,229,0.49
370,14,0,0,0,2
371,229.25,654,431,223,0.484
372,242,700,447,253,0.406
373,274.5,694,436,258,0.434
374,316,688,442,246,0.428
375,19.5,0,0,0,2
376,20,0,0,0,2
377,302.75,676,435,241,0.454
378,229.25,689,430,259,0.451
379,32,2,2,0,1.994
380,290.25,674,429,245,0.468
381,273.5,651,427,224,0.495
382,14.25,0,0,0,2
383,276,694,441,253,0.424
384,310.25,689,432,257,0.447
385,8,0,0,0,2
386,4.75,0,0,0,2
387,247.25,656,421,235,0.502
388,273.5,645,414,231,0.527
389,14.25,0,0,0,2
390,212.75,662,429,233,0.48
391,285.5,659,426,233,0.489
392,13.75,0,0,0,2
393,266.75,692,436,256,0.436
394,252.5,681,431,250,0.457
395,233.25,674,439,235,0.448
396,243.5,665,435,230,0.465
397,14.75,0,0,0,2
398,255.75,663,429,234,0.479
399,20,0,0,0,2
400,249,640,421,219,0.518
401,289.5,703,452,251,0.393
402,273,721,446,275,0.387
403,314.25,676,428,248,0.468
404,18.5,0,0,0,2
405,196.25,709,451,258,0.389
406,267,657,440,217,0.463
407,319.5,689,437,252,0.437
408,13.25,0,0,0,2
409,227.5,658,432,226,0.478
410,29.75,0,0,0,2
411,7.25,0,0,0,2
412,337.75,625,401,224,0.573
413,241.75,684,431,253,0.454
414,231.5,691,445,246,0.419
415,260.75,617,403,214,0.577
416,9.5,0,0,0,2
417,323.25,665,429,236,0.477
418,12.25,0,0,0,2
419,6.75,0,0,0,2
420,270.75,713,444,269,0.399
421,238.75,634,413,221,0.54
422,247.75,622,412,210,0.554
423,291.5,677,420,257,0.483
424,228.75,709,453,256,0.385
425,241.25,662,421,241,0.496
426,220.75,683,428,255,0.461
427,331.75,714,454,260,0.378
428,213.25,660,430,230,0.48
429,235.75,677,437,240,0.449
430,22.25,1,1,0,1.997
431,9.5,0,0,0,2
432,276.75,730,452,278,0.366
433,232,669,424,245,0.483
434,42.25,2,2,0,1.994
435,260.25,669,426,243,0.479
436,352.5,698,444,254,0.414
437,11.5,0,0,0,2
438,224.5,667,425,242,0.483
439,225.75,662,442,220,0.454
440,8.25,0,0,0,2
441,281.25,713,449,264,0.389
442,275,674,425,249,0.476
443,241.5,686,436,250,0.442
444,311.25,693,433,260,0.441
445,22.75,2,2,0,1.994
446,13.25,0,0,0,2
447,241.75,674,439,235,0.448
448,390,637,415,222,0.533
449,269,686,435,251,0.444
450,309.5,671,434,237,0.461
451,221.25,651,419,232,0.511
452,282.25,695,430,265,0.445
453,237.75,748,456,292,0.34
454,237.25,729,452,277,0.367
455,211.25,658,434,224,0.474
456,11.75,0,0,0,2
457,273.5,684,430,254,0.456
458,227.75,676,434,242,0.456
459,5.5,0,0,0,2
460,264,690,448,242,0.414
461,251.5,687,434,253,0.445
462,15.25,0,0,0,2
463,53.25,10,7,3,1.976
464,298.75,679,421,258,0.479
465,16.5,0,0,0,2
466,220.25,702,432,270,0.434
467,266.75,714,453,261,0.38
468,242.25,670,432,238,0.466
469,317,673,440,233,0.447
470,275,712,446,266,0.396
471,271.5,656,430,226,0.484
472,322.75,733,458,275,0.351
473,16.75,0,0,0,2
474,277.5,674,442,232,0.442
475,340.25,719,439,280,0.403
476,5.5,0,0,0,2
477,297.75,704,440,264,0.416
478,302.5,627,423,204,0.527
479,288.5,730,442,288,0.386
480,22.25,0,0,0,2
481,296.75,662,415,247,0.508
482,262.5,695,438,257,0.429
483,7.75,0,0,0,2
484,282,692,441,251,0.426
485,18,0,0,0,2
486,271,686,431,255,0.452
487,7,0,0,0,2
488,22.5,1,1,0,1.997
489,246.5,674,425,249,0.476
490,256.5,712,451,261,0.386
491,214.75,659,430,229,0.481
492,219.75,693,434,259,0.439
493,18,1,1,0,1.997
494,352.75,655,427,228,0.491
495,289,670,417,253,0.496
496,221.75,689,430,259,0.451
497,275,706,456,250,0.382
498,249,677,432,245,0.459
499,282,633,414,219,0.539
500,82.75,6,5,1,1.984
501,344.75,659,433,226,0.475
502,240,702,448,254,0.402
503,245,700,451,249,0.398
504,290.75,698,440,258,0.422
505,10.25,0,0,0,2
506,306,692,441,251,0.426
507,269,711,451,260,0.387
508,15.5,0,0,0,2
509,332.75,694,445,249,0.416
510,11.25,0,0,0,2
511,277.5,660,434,226,0.472
512,252.5,662,435,227,0.468
513,268.75,716,446,270,0.392
514,20.5,0,0,0,2
515,220.25,639,422,217,0.517
516,236.5,640,419,221,0.522
517,30.25,2,2,0,1.994
518,302.5,671,438,233,0.453
519,24.75,0,0,0,2
520,299.5,658,409,249,0.524
521,18.75,0,0,0,2
522,2.75,0,0,0,2
523,244.5,656,428,228,0.488
524,42,2,1,1,1.996
525,281.75,688,439,249,0.434
526,264.5,631,412,219,0.545
527,321,660,420,240,0.5
528,15.75,0,0,0,2
529,287.5,684,426,258,0.464
530,16.5,1,0,1,1.999
531,317.25,666,438,228,0.458
532,38.5,3,3,0,1.991
533,297.75,715,434,281,0.417
534,30.5,1,0,1,1.999
535,341.25,679,430,249,0.461
536,276.75,700,439,261,0.422
537,6,0,0,0,2
538,4,0,0,0,2
539,30,2,1,1,1.996
540,11.75,0,0,0,2
541,222.25,660,433,227,0.474
542,389.5,652,419,233,0.51
543,28.5,2,1,1,1.996
544,286.5,703,447,256,0.403
545,20.25,1,1,0,1.997
546,242,686,423,263,0.468
547,239.5,711,455,256,0.379
548,374.25,720,453,267,0.374
549,215.25,716,446,270,0.392
550,253.25,624,419,205,0.538
551,8.5,0,0,0,2
552,253,726,451,275,0.372
553,18,0,0,0,2
554,302,678,428,250,0.466
555,240.25,678,439,239,0.444
556,322.75,659,424,235,0.493
557,247.5,731,447,284,0.375
558,283.75,647,430,217,0.493
559,36,1,1,0,1.997
560,12.75,0,0,0,2
561,19.5,0,0,0,2
562,10.5,0,0,0,2
563,263.5,644,416,228,0.524
564,262.75,667,435,232,0.463
565,288.75,721,452,269,0.375
566,39.75,1,1,0,1.997
567,251,655,425,230,0.495
568,300.25,706,452,254,0.39
569,294.5,698,437,261,0.428
570,17,0,0,0,2
571,304.75,639,421,218,0.519
572,279,688,426,262,0.46
573,22.5,1,1,0,1.997
574,12.25,0,0,0,2
575,279.25,701,437,264,0.425
576,227.5,714,444,270,0.398
577,261.5,669,431,238,0.469
578,29,2,2,0,1.994
579,281.75,677,438,239,0.447
580,8.75,0,0,0,2
581,259.25,715,452,263,0.381
582,321.25,671,435,236,0.459
583,55,4,3,1,1.99
584,385,713,442,271,0.403
585,242,715,446,269,0.393
586,317.75,727,450,277,0.373
587,256.75,682,438,244,0.442
588,51,3,2,1,1.993
589,259.5,715,439,276,0.407
590,242.75,665,433,232,0.469
591,35.5,4,4,0,1.988
592,12.75,0,0,0,2
593,9.5,0,0,0,2
594,263.75,715,448,267,0.389
595,278.25,678,436,242,0.45
596,309.5,685,432,253,0.451
597,298.5,680,444,236,0.432
598,230.25,611,392,219,0.605
599,334.25,683,435,248,0.447
600,8.25,0,0,0,2
601,26,0,0,0,2
602,249.25,642,417,225,0.524
603,21.25,1,1,0,1.997
604,279.5,742,459,283,0.34
605,285.5,717,442,275,0.399
606,20.75,0,0,0,2
607,261.25,619,411,208,0.559
608,23,1,0,1,1.999
609,216.25,674,427,247,0.472
610,243.75,717,446,271,0.391
611,237,708,444,264,0.404
612,270.75,681,435,246,0.449
613,249.5,693,430,263,0.447
614,267.25,703,436,267,0.425
615,251.75,707,453,254,0.387
616,37.75,5,2,3,1.991
617,35.5,3,1,2,1.995
618,27.75,0,0,0,2
619,6.25,0,0,0,2
620,27,1,1,0,1.997
621,294.5,646,412,234,0.53
622,27,0,0,0,2
623,18.25,0,0,0,2
624,9,0,0,0,2
625,6.75,0,0,0,2
626,295.5,704,458,246,0.38
627,267.75,687,445,242,0.423
628,32,1,1,0,1.997
629,262.25,696,438,258,0.428
630,289.75,657,412,245,0.519
631,31.5,1,1,0,1.997
632,237.5,676,433,243,0.458
633,229.75,702,457,245,0.384
634,208.75,676,433,243,0.458
635,205.5,665,425,240,0.485
636,16.5,0,0,0,2
637,270.25,684,431,253,0.454
638,44.25,1,1,0,1.997
639,228.75,699,456,243,0.389
640,19.75,0,0,0,2
641,9.75,0,0,0,2
642,305.5,619,414,205,0.553
643,299.5,719,456,263,0.369
644,300.25,653,415,238,0.517
645,276.75,695,428,267,0.449
646,288.5,637,402,235,0.559
647,285.25,700,444,256,0.412
648,292.5,715,438,277,0.409
649,260.25,667,442,225,0.449
650,313.25,692,443,249,0.422
651,14,0,0,0,2
652,14.75,0,0,0,2
653,232.25,647,417,230,0.519
654,262.5,718,455,263,0.372
655,58.25,3,3,0,1.991
656,270.5,711,439,272,0.411
657,349,658,422,236,0.498
658,301.5,661,426,235,0.487
659,18.25,0,0,0,2
660,269.75,617,407,210,0.569
661,24,0,0,0,2
662,237,695,447,248,0.411
663,246.75,743,454,289,0.349
664,15.75,1,1,0,1.997
665,249.5,674,427,247,0.472
666,295.5,658,418,240,0.506
667,259.5,667,436,231,0.461
668,3.25,0,0,0,2
669,278.5,681,430,251,0.459
670,359.75,674,434,240,0.458
671,10.75,0,0,0,2
672,296.5,651,419,232,0.511
673,13.5,0,0,0,2
674,335.5,696,431,265,0.442
675,238.5,687,429,258,0.455
676,25.25,0,0,0,2
677,275,681,444,237,0.431
678,36.5,1,1,0,1.997
679,281.5,658,418,240,0.506
680,199,637,411,226,0.541
681,3.25,0,0,0,2
682,9.25,0,0,0,2
683,269,626,412,214,0.55
684,234,706,450,256,0.394
685,8.75,0,0,0,2
686,22,0,0,0,2
687,238.75,667,429,238,0.475
688,34.5,1,0,1,1.999
689,279.25,660,422,238,0.496
690,10.75,0,0,0,2
691,236.25,644,420,224,0.516
692,11.25,0,0,0,2
693,24.5,0,0,0,2
694,222.5,711,451,260,0.387
695,356.25,670,426,244,0.478
696,11.5,0,0,0,2
697,235,720,449,271,0.382
698,43,1,1,0,1.997
699,20.75,1,1,0,1.997
700,8.5,0,0,0,2
701,227.25,673,425,248,0.477
702,245,663,425,238,0.487
703,245,688,451,237,0.41
704,5,0,0,0,2
705,196,661,422,239,0.495
706,191.5,640,414,226,0.532
707,47.5,3,2,1,1.993
708,11.25,0,0,0,2
709,267.75,667,433,234,0.467
710,306.5,676,441,235,0.442
711,267.75,634,412,222,0.542
712,25,0,0,0,2
713,215.75,665,435,230,0.465
714,276.25,728,456,272,0.36
715,260.75,693,437,256,0.433
716,258.5,682,441,241,0.436
717,284.5,711,443,268,0.403
718,223.5,685,432,253,0.451
719,239.5,728,453,275,0.366
720,242,672,427,245,0.474
721,248,661,433,228,0.473
722,270.25,667,421,246,0.491
723,258,715,448,267,0.389
724,265,689,444,245,0.423
725,16.5,0,0,0,2
726,10.75,0,0,0,2
727,301.75,710,445,265,0.4
728,16.75,0,0,0,2
729,216.5,719,447,272,0.387
730,14.5,0,0,0,2
731,323,650,426,224,0.498
732,32.25,2,1,1,1.996
733,342.25,697,433,264,0.437
734,266.75,671,425,246,0.479
735,7.25,0,0,0,2
736,301.75,650,415,235,0.52
737,315.75,680,436,244,0.448
738,4,0,0,0,2
739,352.5,674,435,239,0.456
740,18,0,0,0,2
741,78,5,3,2,1.989
742,288.75,680,429,251,0.462
743,267.75,689,438,251,0.435
744,323.25,673,428,245,0.471
745,293.75,733,455,278,0.357
746,217.5,659,434,225,0.473
747,81.25,4,2,2,1.992
748,316.25,620,418,202,0.544
749,13,0,0,0,2
750,327.75,730,450,280,0.37
751,241,683,439,244,0.439
752,27.75,2,2,0,1.994
753,306.25,673,434,239,0.459
754,15,0,0,0,2
755,242,660,423,237,0.494
756,295,675,426,249,0.473
757,8,0,0,0,2
758,222.75,658,418,240,0.506
759,229.5,690,445,245,0.42
760,211.5,702,447,255,0.404
761,284.25,661,437,224,0.465
762,224,704,444,260,0.408
763,20.75,0,0,0,2
764,310.5,673,430,243,0.467
765,40.75,6,6,0,1.982
766,218.25,700,443,257,0.414
767,6,0,0,0,2
768,308,700,454,246,0.392
769,229,703,440,263,0.417
770,23,0,0,0,2
771,258,678,437,241,0.448
772,248.5,611,413,198,0.563
773,270.25,685,438,247,0.439
774,19.75,0,0,0,2
775,12,0,0,0,2
776,248.5,708,442,266,0.408
777,13.25,0,0,0,2
778,36.25,1,0,1,1.999
779,287.25,665,433,232,0.469
780,240.25,687,438,249,0.437
781,19,0,0,0,2
782,295.5,722,454,268,0.37
783,10.5,0,0,0,2
784,42.5,1,1,0,1.997
785,255.25,689,437,252,0.437
786,275.75,673,422,251,0.483
787,260.75,682,421,261,0.476
788,246.25,704,448,256,0.4
789,13.5,0,0,0,2
790,241.5,670,432,238,0.466
791,294,695,431,264,0.443
792,303.25,674,439,235,0.448
793,20.5,0,0,0,2
794,7.25,0,0,0,2
795,286.25,684,448,236,0.42
796,228,740,458,282,0.344
797,21.75,0,0,0,2
798,271,673,435,238,0.457
799,238.25,701,441,260,0.417
800,313.5,721,450,271,0.379
801,7.5,0,0,0,2
802,312.5,655,425,230,0.495
803,15,0,0,0,2
804,291,670,421,249,0.488
805,6.75,0,0,0,2
806,263.5,708,443,265,0.406
807,264,689,449,240,0.413
808,247.25,645,428,217,0.499
809,11.75,0,0,0,2
810,303.75,709,441,268,0.409
811,6.25,0,0,0,2
812,15.25,0,0,0,2
813,214.5,722,458,264,0.362
814,43.75,1,1,0,1.997
815,23.5,1,1,0,1.997
816,275.75,670,429,241,0.472
817,247,727,458,269,0.357
818,18.25,1,0,1,1.999
819,6.5,0,0,0,2
820,270.75,696,443,253,0.418
821,306.75,656,428,228,0.488
822,300.75,676,435,241,0.454
823,243.75,670,438,232,0.454
824,326.5,652,429,223,0.49
825,17.25,0,0,0,2
826,75.25,3,2,1,1.993
827,312,693,447,246,0.413
828,239.25,676,432,244,0.46
829,222.25,710,445,265,0.4
830,314.75,713,455,258,0.377
831,344.75,690,432,258,0.446
832,23.5,0,0,0,2
833,224.25,708,449,259,0.394
834,361.25,692,438,254,0.432
835,238.5,690,427,263,0.456
836,301.5,732,452,280,0.364
837,8.25,0,0,0,2
838,242.25,693,428,265,0.451
839,308,692,444,248,0.42
840,222,695,439,256,0.427
841,373.5,662,432,230,0.474
842,7.25,0,0,0,2
843,270.75,701,435,266,0.429
844,198.25,668,437,231,0.458
845,226.5,691,435,256,0.439
846,6,0,0,0,2
847,27.25,1,0,1,1.999
848,273.25,669,433,236,0.465
849,261.25,690,447,243,0.416
850,294.75,687,438,249,0.437
851,7.75,0,0,0,2
852,29.5,1,1,0,1.997
853,16.75,0,0,0,2
854,51,1,0,1,1.999
855,30.25,0,0,0,2
856,37.75,1,0,1,1.999
857,245,686,438,248,0.438
858,14,0,0,0,2
859,265.5,697,455,242,0.393
860,303,651,424,227,0.501
861,58,4,4,0,1.988
862,26.5,0,0,0,2
863,314.25,688,432,256,0.448
864,30.25,3,3,0,1.991
865,15,0,0,0,2
866,286.75,697,446,251,0.411
867,243,704,442,262,0.412
868,280.25,703,452,251,0.393
869,282.25,675,432,243,0.461
870,269.25,705,448,257,0.399
871,250.5,746,460,286,0.334
872,249,710,447,263,0.396
873,264.5,739,445,294,0.371
874,343.5,728,447,281,0.378
875,279.25,695,438,257,0.429
876,12.25,0,0,0,2
877,208.25,717,445,272,0.393
878,20,1,0,1,1.999
879,11.75,0,0,0,2
880,240.5,686,440,246,0.434
881,249.5,669,429,240,0.473
882,358,698,439,259,0.424
883,214,719,461,258,0.359
884,9,0,0,0,2
885,28,1,1,0,1.997
886,300,697,433,264,0.437
887,300.25,659,432,227,0.477
888,12.75,0,0,0,2
889,8.75,0,0,0,2
890,267.5,650,415,235,0.52
891,260.5,668,429,239,0.474
892,270.5,715,447,268,0.391
893,274,681,425,256,0.469
894,28.5,0,0,0,2
895,13.5,0,0,0,2
896,271.25,665,428,237,0.479
897,28.75,0,0,0,2
898,11.5,0,0,0,2
899,248.5,707,452,255,0.389
900,185.75,688,444,244,0.424
901,249,667,431,236,0.471
902,254.75,682,433,249,0.452
903,9.5,0,0,0,2
904,57.25,10,5,5,1.98
905,15.5,0,0,0,2
906,272.75,658,437,221,0.468
907,19.75,1,1,0,1.997
908,243.75,690,439,251,0.432
909,15.75,1,0,1,1.999
910,10.75,0,0,0,2
911,19.75,0,0,0,2
912,267.25,640,414,226,0.532
913,8.5,0,0,0,2
914,13.75,0,0,0,2
915,265.5,651,429,222,0.491
916,292.75,705,446,259,0.403
917,16,0,0,0,2
918,247.5,649,428,221,0.495
919,243.25,709,449,260,0.393
920,20.75,0,0,0,2
921,243.5,674,423,251,0.48
922,45.75,2,2,0,1.994
923,9.5,0,0,0,2
924,222.75,659,430,229,0.481
925,274.75,682,436,246,0.446
926,283,608,404,204,0.584
927,261.5,681,443,238,0.433
928,284,712,447,265,0.394
929,233,663,423,240,0.491
930,279.5,693,434,259,0.439
931,276.75,695,437,258,0.431
932,246.5,705,452,253,0.391
933,258.75,684,433,251,0.45
934,56,5,4,1,1.987
935,23,3,2,1,1.993
936,260.5,703,440,263,0.417
937,9.5,0,0,0,2
938,9.25,0,0,0,2
939,14.25,0,0,0,2
940,27.25,3,2,1,1.993
941,16.75,0,0,0,2
942,250.25,663,421,242,0.495
943,235,694,439,255,0.428
944,326.5,636,421,215,0.522
945,199.25,672,439,233,0.45
946,270.25,616,403,213,0.578
947,404.75,655,435,220,0.475
948,252.5,650,426,224,0.498
949,200.5,674,427,247,0.472
950,306.5,707,455,252,0.383
951,17.75,0,0,0,2
952,259.25,687,437,250,0.439
953,269.25,709,453,256,0.385
954,6,0,0,0,2
955,407,685,433,252,0.449
956,241.75,662,436,226,0.466
957,306,686,443,243,0.428
958,269,657,433,224,0.477
959,3.25,0,0,0,2
960,244.25,707,438,269,0.417
961,27.5,0,0,0,2
962,231.75,693,444,249,0.419
963,322.25,697,436,261,0.431
964,15,1,1,0,1.997
965,211.25,697,441,256,0.421
966,208.25,666,441,225,0.452
967,334.5,719,443,276,0.395
968,282.25,673,440,233,0.447
969,6,0,0,0,2
970,272.5,648,408,240,0.536
971,14.75,1,0,1,1.999
972,252.75,708,443,265,0.406
973,250,664,428,236,0.48
974,7.5,0,0,0,2
975,250.5,661,421,240,0.497
976,343.5,689,443,246,0.425
977,302.75,684,442,242,0.432
978,259.75,706,435,271,0.424
979,260.5,681,437,244,0.445
980,29.75,1,1,0,1.997
981,286,704,448,256,0.4
982,331.5,672,439,233,0.45
983,287.25,695,443,252,0.419
984,299.25,659,430,229,0.481
985,376.5,613,408,205,0.571
986,239,695,442,253,0.421
987,266,659,413,246,0.515
988,237.75,690,435,255,0.44
989,310,648,425,223,0.502
990,207.75,667,441,226,0.451
991,18.25,0,0,0,2
992,264.75,669,428,241,0.475
993,6.75,0,0,0,2
994,17.5,0,0,0,2
995,19,0,0,0,2
996,319.5,684,434,250,0.448
997,312,631,404,227,0.561
998,231.25,694,437,257,0.432
999,223.25,659,427,232,0.487
1000,282.5,722,455,267,0.368
1001,251.5,714,447,267,0.392
1002,244,715,447,268,0.391
1003,6.75,0,0,0,2
1004,260,666,424,242,0.486
1005,39.25,4,4,0,1.988
1006,276.25,641,410,231,0.539
1007,288.5,714,443,271,0.4
1008,254.5,709,449,260,0.393
1009,9.75,0,0,0,2
1010,13.25,0,0,0,2
1011,330.75,697,436,261,0.431
1012,201.75,665,418,247,0.499
1013,225.25,663,422,241,0.493
1014,13.25,0,0,0,2
1015,334.25,694,426,268,0.454
1016,284.25,692,436,256,0.436
1017,225.5,711,453,258,0.383
1018,234,682,446,236,0.426
1019,60.5,3,3,0,1.991
1020,13.5,0,0,0,2
1021,41.75,3,1,2,1.995
1022,9.5,0,0,0,2
1023,243,668,430,238,0.472
1024,18.5,0,0,0,2
1025,279.5,675,411,264,0.503
1026,293.25,641,415,226,0.529
1027,76.25,9,7,2,1.977
1028,324.75,698,430,268,0.442
1029,241.5,667,429,238,0.475
1030,9,0,0,0,2
1031,34.5,1,0,1,1.999
1032,27.25,0,0,0,2
1033,295,649,426,223,0.499
1034,271.5,721,448,273,0.383
1035,316,665,426,239,0.483
1036,16.5,0,0,0,2
1037,271.75,700,450,250,0.4
1038,15.25,0,0,0,2
1039,34.25,0,0,0,2
1040,262,673,418,255,0.491
1041,305.25,676,438,238,0.448
1042,289,662,423,239,0.492
1043,295.75,677,430,247,0.463
1044,313,668,426,242,0.48
1045,286,657,419,238,0.505
1046,13.5,0,0,0,2
1047,248.75,652,423,229,0.502
1048,291.25,682,434,248,0.45
1049,260.75,624,413,211,0.55
1050,208.75,702,432,270,0.434
1051,251,750,454,296,0.342
1052,31.25,0,0,0,2
1053,359.5,663,424,239,0.489
1054,82.25,3,3,0,1.991
1055,226.25,673,431,242,0.465
1056,23,1,1,0,1.997
1057,8.75,0,0,0,2
1058,11,0,0,0,2
1059,289,699,439,260,0.423
1060,21.25,0,0,0,2
1061,251,659,427,232,0.487
1062,235,684,438,246,0.44
1063,330,738,451,287,0.36
1064,273.75,698,437,261,0.428
1065,303.25,640,412,228,0.536
1066,15.75,0,0,0,2
1067,22,0,0,0,2
1068,28.75,0,0,0,2
1069,42,2,2,0,1.994
1070,14.75,0,0,0,2
1071,285,692,436,256,0.436
1072,266.25,675,444,231,0.437
1073,243.25,677,427,250,0.469
1074,230.5,682,441,241,0.436
1075,309.75,697,438,259,0.427
1076,227.25,661,435,226,0.469
1077,308,718,447,271,0.388
1078,16.5,0,0,0,2
1079,11.5,0,0,0,2
1080,12.5,0,0,0,2
1081,215.5,672,432,240,0.464
1082,263,675,441,234,0.443
1083,269,719,444,275,0.393
1084,258,685,430,255,0.455
1085,261,642,423,219,0.512
1086,293.75,675,421,254,0.483
1087,10.25,0,0,0,2
1088,294.25,687,437,250,0.439
1089,313.25,711,443,268,0.403
1090,274,700,445,255,0.41
1091,17.75,0,0,0,2
1092,263.5,644,423,221,0.51
1093,8,0,0,0,2
1094,4.25,0,0,0,2
1095,278.5,680,425,255,0.47
1096,250,663,429,234,0.479
1097,258,655,436,219,0.473
1098,244,624,400,224,0.576
1099,270.75,672,428,244,0.472
1100,30.5,0,0,0,2
1101,245.75,694,437,257,0.432
1102,22,0,0,0,2
1103,73.25,5,3,2,1.989
1104,275.75,680,442,238,0.436
1105,5.75,0,0,0,2
1106,228.5,701,444,257,0.411
1107,337,725,441,284,0.393
1108,331.5,722,447,275,0.384
1109,232.25,624,411,213,0.554
1110,49,3,2,1,1.993
1111,326,698,441,257,0.42
1112,49.75,0,0,0,2
1113,270,679,434,245,0.453
1114,272.25,669,428,241,0.475
1115,38.25,1,1,0,1.997
1116,310.75,663,424,239,0.489
1117,265.75,702,440,262,0.418
1118,281.75,682,430,252,0.458
1119,235,689,441,248,0.429
1120,16,0,0,0,2
1121,16,0,0,0,2
1122,256.75,653,410,243,0.527
1123,12.25,0,0,0,2
1124,326.25,686,434,252,0.446
1125,248.75,698,447,251,0.408
1126,242.5,705,452,253,0.391
1127,305.5,703,451,252,0.395
1128,239.75,626,404,222,0.566
1129,255.75,715,445,270,0.395
1130,328.25,680,439,241,0.442
1131,263,672,442,230,0.444
1132,287,655,423,232,0.499
1133,244,714,450,264,0.386
1134,296.5,644,422,222,0.512
1135,8.25,0,0,0,2
1136,222.25,686,445,241,0.424
1137,264.25,686,442,244,0.43
1138,296.25,670,433,237,0.464
1139,325.75,661,427,234,0.485
1140,23.75,0,0,0,2
1141,241.75,718,448,270,0.386
1142,256.25,724,448,276,0.38
1143,13.25,0,0,0,2
1144,299.75,695,443,252,0.419
1145,329.75,658,436,222,0.47
1146,296.25,644,417,227,0.522
1147,16.75,0,0,0,2
1148,225.25,694,444,250,0.418
1149,20.75,0,0,0,2
1150,222.5,652,414,238,0.52
1151,318,679,437,242,0.447
1152,205.5,656,425,231,0.494
1153,392.5,684,439,245,0.438
1154,247.5,709,440,269,0.411
1155,9.25,0,0,0,2
1156,221.25,739,452,287,0.357
1157,6.75,0,0,0,2
1158,347.5,640,420,220,0.52
1159,14.25,0,0,0,2
1160,233.25,699,441,258,0.419
1161,247.25,683,437,246,0.443
1162,18,0,0,0,2
1163,12.75,0,0,0,2
1164,230.25,687,440,247,0.433
1165,297.5,670,435,235,0.46
1166,7.25,0,0,0,2
1167,285.25,646,428,218,0.498
1168,220.5,698,443,255,0.416
1169,11.25,0,0,0,2
1170,292.5,708,446,262,0.4
1171,17.5,0,0,0,2
1172,3,0,0,0,2
1173,237.25,616,409,207,0.566
1174,300.5,732,456,276,0.356
1175,302.25,713,448,265,0.391
1176,264,650,423,227,0.504
1177,363.75,665,427,238,0.481
1178,264.5,723,448,275,0.381
1179,220,690,433,257,0.444
1180,258.5,632,416,216,0.536
1181,250,687,441,246,0.431
1182,11.25,0,0,0,2
1183,288.25,730,446,284,0.378
1184,68.5,3,2,1,1.993
1185,244.25,662,429,233,0.48
1186,270.75,653,422,231,0.503
1187,36.5,1,1,0,1.997
1188,291.75,616,398,218,0.588
1189,14.75,0,0,0,2
1190,255.25,696,438,258,0.428
1191,226.75,710,446,264,0.398
1192,200.5,700,445,255,0.41
1193,299.75,640,417,223,0.526
1194,19,0,0,0,2
1195,242.5,661,432,229,0.475
1196,39,2,1,1,1.996
1197,242,731,449,282,0.371
1198,325,602,398,204,0.602
1199,272,648,419,229,0.514
1200,262.25,710,431,279,0.428
1201,277.75,668,416,252,0.5
1202,216.5,708,449,259,0.394
1203,7.5,0,0,0,2
1204,289.75,614,411,203,0.564
1205,336,671,431,240,0.467
1206,8.5,0,0,0,2
1207,11.5,0,0,0,2
1208,261.5,680,443,237,0.434
1209,307.5,698,433,265,0.436
1210,207.5,705,448,257,0.399
1211,208.5,699,441,258,0.419
1212,10.75,0,0,0,2
1213,30.25,0,0,0,2
1214,32.25,1,0,1,1.999
1215,267.75,656,431,225,0.482
1216,326,738,450,288,0.362
1217,293.75,644,408,236,0.54
1218,253,701,446,255,0.407
1219,34,1,0,1,1.999
1220,228.5,684,431,253,0.454
1221,230.75,715,443,272,0.399
1222,13.5,0,0,0,2
1223,290.5,709,436,273,0.419
1224,354.25,653,423,230,0.501
1225,12.5,0,0,0,2
1226,16,0,0,0,2
1227,242,700,441,259,0.418
1228,284,679,431,248,0.459
1229,252.75,724,448,276,0.38
1230,212.25,653,430,223,0.487
1231,298.25,686,421,265,0.472
1232,259.25,658,420,238,0.502
1233,245.5,670,430,240,0.47
1234,341.75,672,425,247,0.478
1235,38.75,0,0,0,2
1236,272.25,647,423,224,0.507
1237,31,0,0,0,2
1238,352.75,678,436,242,0.45
1239,15,0,0,0,2
1240,225.5,667,435,232,0.463
1241,253,659,433,226,0.475
1242,15,0,0,0,2
1243,267,666,448,218,0.438
1244,254.25,719,447,272,0.387
1245,306.5,617,404,213,0.575
1246,368,706,436,270,0.422
1247,300.5,684,430,254,0.456
1248,34,3,3,0,1.991
1249,283.75,690,442,248,0.426
1250,45.5,3,3,0,1.991
1251,246,699,441,258,0.419
1252,256.25,684,433,251,0.45
1253,287.5,679,435,244,0.451
1254,331.25,694,437,257,0.432
1255,296,668,435,233,0.462
1256,82.5,6,5,1,1.984
1257,392.75,639,414,225,0.533
1258,17,1,1,0,1.997
1259,11.75,0,0,0,2
1260,8.75,1,0,1,1.999
1261,260.5,675,421,254,0.483
1262,36.5,3,1,2,1.995
1263,256.75,659,429,230,0.483
1264,241.25,733,453,280,0.361
1265,12.5,0,0,0,2
1266,256.25,644,426,218,0.504
1267,270.5,693,443,250,0.421
1268,325,710,450,260,0.39
1269,265.5,711,445,266,0.399
1270,35.25,2,1,1,1.996
1271,238.5,694,451,243,0.404
1272,211.5,708,457,251,0.378
1273,229.75,658,426,232,0.49
1274,390.5,713,438,275,0.411
1275,14.75,0,0,0,2
1276,210.5,744,450,294,0.356
1277,232,653,433,220,0.481
1278,16,0,0,0,2
1279,300.75,664,428,236,0.48
1280,252.75,705,450,255,0.395
1281,291.75,714,452,262,0.382
1282,259.75,657,428,229,0.487
1283,273,731,464,267,0.341
1284,408.25,692,445,247,0.418
1285,335.75,635,406,229,0.553
1286,227.5,669,430,239,0.471
1287,26.75,1,1,0,1.997
1288,191.5,709,452,257,0.387
1289,219.75,665,425,240,0.485
1290,230,740,469,271,0.322
1291,231.75,703,449,254,0.399
1292,3,0,0,0,2
1293,256,646,420,226,0.514
1294,4.5,0,0,0,2
1295,243,657,417,240,0.509
1296,28,0,0,0,2
1297,430,628,404,224,0.564
1298,8.5,0,0,0,2
1299,236.5,647,431,216,0.491
1300,224.75,679,433,246,0.455
1301,15.25,0,0,0,2
1302,258.25,647,409,238,0.535
1303,273.75,701,455,246,0.389
1304,14.75,0,0,0,2
1305,11.75,0,0,0,2
1306,12.5,0,0,0,2
1307,22,2,2,0,1.994
1308,267,699,434,265,0.433
1309,19.25,0,0,0,2
1310,12.25,0,0,0,2
1311,283.25,692,428,264,0.452
1312,297.25,654,427,227,0.492
1313,309.5,701,436,265,0.427
1314,274.25,686,431,255,0.452
1315,234,698,445,253,0.412
1316,23,0,0,0,2
1317,287.5,685,447,238,0.421
1318,246.75,649,415,234,0.521
1319,10.5,0,0,0,2
1320,343.25,701,435,266,0.429
1321,204.75,688,443,245,0.426
1322,216,705,438,267,0.419
1323,269,704,436,268,0.424
1324,11.75,0,0,0,2
1325,9.25,0,0,0,2
1326,240.75,703,434,269,0.429
1327,14.75,0,0,0,2
1328,351.75,698,439,259,0.424
1329,11,1,1,0,1.997
1330,13,0,0,0,2
1331,9.5,0,0,0,2
1332,244.5,680,433,247,0.454
1333,6.75,0,0,0,2
1334,310,675,436,239,0.453
1335,232.75,677,446,231,0.431
1336,264,633,407,226,0.553
1337,71.75,15,11,4,1.963
1338,230,711,432,279,0.425
1339,233.5,700,438,262,0.424
1340,12.5,0,0,0,2
1341,248.25,683,428,255,0.461
1342,310.75,690,442,248,0.426
1343,224.25,676,420,256,0.484
1344,237,650,413,237,0.524
1345,204.25,695,446,249,0.413
1346,11.25,0,0,0,2
1347,10.25,0,0,0,2
1348,289,680,426,254,0.468
1349,324.5,674,435,239,0.456
1350,237.25,754,460,294,0.326
1351,262.25,697,446,251,0.411
1352,242,662,425,237,0.488
1353,331.25,708,439,269,0.414
1354,211,689,445,244,0.421
1355,249.5,705,447,258,0.401
1356,234.25,669,433,236,0.465
1357,5.75,0,0,0,2
1358,260.25,697,446,251,0.411
1359,337,662,431,231,0.476
1360,222.5,694,437,257,0.432
1361,218.75,664,424,240,0.488
1362,234.5,685,436,249,0.443
1363,31.5,2,2,0,1.994
1364,37.75,3,2,1,1.993
1365,16,0,0,0,2
1366,365,678,445,233,0.432
1367,7,0,0,0,2
1368,302,694,442,252,0.422
1369,275.75,684,426,258,0.464
1370,302,680,438,242,0.444
1371,44.5,2,2,0,1.994
1372,222.25,691,434,257,0.441
1373,248.75,633,407,226,0.553
1374,283.25,737,456,281,0.351
1375,286.75,658,418,240,0.506
1376,364.5,710,439,271,0.412
1377,324.75,679,427,252,0.467
1378,247.5,665,419,246,0.497
1379,6.75,0,0,0,2
1380,287.5,682,434,248,0.45
1381,273.25,671,427,244,0.475
1382,286,678,435,243,0.452
1383,224,708,439,269,0.414
1384,233,649,433,216,0.485
1385,252,706,451,255,0.392
1386,281.25,702,428,274,0.442
1387,9.75,0,0,0,2
1388,292,713,445,268,0.397
1389,33.5,2,2,0,1.994
1390,13.5,0,0,0,2
1391,16.25,0,0,0,2
1392,210,678,444,234,0.434
1393,229.25,704,442,262,0.412
1394,9.5,0,0,0,2
1395,222.25,726,444,282,0.386
1396,314.5,660,418,242,0.504
1397,254.5,729,461,268,0.349
1398,16.5,0,0,0,2
1399,218.75,666,434,232,0.466
1400,272.5,711,449,262,0.391
1401,303.5,659,431,228,0.479
1402,9.75,0,0,0,2
1403,227,696,434,262,0.436
1404,28.75,0,0,0,2
1405,15.75,0,0,0,2
1406,336,686,438,248,0.438
1407,26,0,0,0,2
1408,210.75,682,441,241,0.436
1409,239.5,627,417,210,0.539
1410,15,0,0,0,2
1411,357,675,431,244,0.463
1412,12.25,0,0,0,2
1413,239.25,685,432,253,0.451
1414,236.75,695,445,250,0.415
1415,257,727,445,282,0.383
1416,31,2,2,0,1.994
1417,32.5,4,4,0,1.988
1418,49.75,5,4,1,1.987
1419,25.75,0,0,0,2
1420,283.75,665,423,242,0.489
1421,272.25,660,417,243,0.506
1422,318.25,701,446,255,0.407
1423,346.75,636,426,210,0.512
1424,312,680,429,251,0.462
1425,7.5,0,0,0,2
1426,19.5,2,0,2,1.998
1427,18.75,1,1,0,1.997
1428,328.25,689,431,258,0.449
1429,256.75,701,441,260,0.417
1430,332,685,443,242,0.429
1431,13.75,0,0,0,2
1432,300.75,642,414,228,0.53
1433,25.25,1,0,1,1.999
1434,243.75,685,426,259,0.463
1435,8.25,0,0,0,2
1436,314.75,661,417,244,0.505
1437,246.5,678,439,239,0.444
1438,26.25,0,0,0,2
1439,313.75,602,389,213,0.62
1440,261.75,704,452,252,0.392
1441,206.25,691,439,252,0.431
1442,12,0,0,0,2
1443,7.75,0,0,0,2
1444,19.75,0,0,0,2
1445,268,680,443,237,0.434
1446,322.75,686,429,257,0.456
1447,284.5,649,413,236,0.525
1448,22.25,0,0,0,2
1449,330.5,706,443,263,0.408
1450,300.75,628,416,212,0.54
1451,12.75,1,1,0,1.997
1452,295.5,666,434,232,0.466
1453,233.75,652,410,242,0.528
1454,253,722,446,276,0.386
1455,306,675,424,251,0.477
1456,253.5,682,432,250,0.454
1457,284.75,625,418,207,0.539
1458,284.25,675,436,239,0.453
1459,293.25,652,431,221,0.486
1460,48.25,1,1,0,1.997
1461,333.25,703,430,273,0.437
1462,22,1,1,0,1.997
1463,339.25,651,423,228,0.503
1464,30.75,2,1,1,1.996
1465,308.25,719,453,266,0.375
1466,15,0,0,0,2
1467,96.5,12,12,0,1.964
1468,28.25,2,2,0,1.994
1469,32.25,1,0,1,1.999
1470,22,1,1,0,1.997
1471,4.25,0,0,0,2
1472,285.5,668,430,238,0.472
1473,286.25,693,447,246,0.413
1474,4.25,0,0,0,2
1475,30.5,0,0,0,2
1476,10.75,0,0,0,2
1477,277.75,720,453,267,0.374
1478,8.25,0,0,0,2
1479,287.5,673,435,238,0.457
1480,273,678,427,251,0.468
1481,306,701,445,256,0.409
1482,14,0,0,0,2
1483,365,692,436,256,0.436
1484,280.75,676,441,235,0.442
1485,313.25,675,432,243,0.461
1486,268,669,431,238,0.469
1487,257.25,655,414,241,0.517
1488,209.5,686,435,251,0.444
1489,9.75,0,0,0,2
1490,343.25,594,389,205,0.628
1491,265.25,699,431,268,0.439
1492,294,630,421,209,0.528
1493,240.5,711,453,258,0.383
1494,251.25,701,435,266,0.429
1495,252.75,698,428,270,0.446
1496,259.75,748,455,293,0.342
1497,298.5,703,434,269,0.429
1498,273.25,661,429,232,0.481
1499,230.75,631,417,214,0.535
1500,315.75,677,430,247,0.463
1501,20,0,0,0,2
1502,329.5,682,426,256,0.466
1503,54.25,4,3,1,1.99
1504,341,642,419,223,0.52
1505,297.5,653,419,234,0.509
1506,375.25,643,417,226,0.523
1507,260.75,727,444,283,0.385
1508,293.75,680,436,244,0.448
1509,271.5,714,445,269,0.396
1510,229.75,699,441,258,0.419
1511,217.25,707,455,252,0.383
1512,15.75,0,0,0,2
1513,287.25,661,429,232,0.481
1514,307.5,653,435,218,0.477
1515,274,714,450,264,0.386
1516,8.5,0,0,0,2
1517,289.25,701,440,261,0.419
1518,22,0,0,0,2
1519,237.25,649,419,230,0.513
1520,240.5,696,438,258,0.428
1521,192.25,714,445,269,0.396
1522,341,678,437,241,0.448
1523,8.5,0,0,0,2
1524,328.5,651,422,229,0.505
1525,19.25,1,1,0,1.997
1526,307.75,717,450,267,0.383
1527,273.25,736,456,280,0.352
1528,268.75,689,446,243,0.419
1529,46.75,1,1,0,1.997
1530,233.75,688,423,265,0.466
1531,225.75,668,414,254,0.504
1532,271.75,667,432,235,0.469
1533,296.5,663,424,239,0.489
1534,313.5,622,419,203,0.54
1535,240.75,649,417,232,0.517
1536,288.25,698,439,259,0.424
1537,17.75,1,1,0,1.997
1538,228.25,683,437,246,0.443
1539,8.25,0,0,0,2
1540,9.5,0,0,0,2
1541,269,686,418,268,0.478
1542,22.5,0,0,0,2
1543,251.25,706,440,266,0.414
1544,305.25,698,430,268,0.442
1545,19.75,0,0,0,2
1546,252.5,677,433,244,0.457
1547,17.5,0,0,0,2
1548,275.5,709,444,265,0.403
1549,292.5,645,416,229,0.523
1550,277.75,622,414,208,0.55
1551,233.25,713,448,265,0.391
1552,269.75,682,433,249,0.452
1553,262,635,428,207,0.509
1554,247,631,422,209,0.525
1555,26.5,0,0,0,2
1556,294.25,685,428,257,0.459
1557,257.5,699,446,253,0.409
1558,31,1,1,0,1.997
1559,257.75,667,428,239,0.477
1560,25.75,1,1,0,1.997
1561,337,702,444,258,0.41
1562,50.75,4,3,1,1.99
1563,253.5,635,419,216,0.527
1564,281.5,615,410,205,0.565
1565,276,697,438,259,0.427
1566,240.75,681,427,254,0.465
1567,22,1,1,0,1.997
1568,24.25,0,0,0,2
1569,235.5,741,461,280,0.337
1570,19.75,0,0,0,2
1571,323.75,658,422,236,0.498
1572,228.5,691,438,253,0.433
1573,54.5,2,1,1,1.996
1574,230,720,452,268,0.376
1575,20.5,1,1,0,1.997
1576,29.75,1,1,0,1.997
1577,284.25,658,428,230,0.486
1578,12.75,0,0,0,2
1579,281.25,622,413,209,0.552
1580,354.5,687,429,258,0.455
1581,268.25,671,424,247,0.481
1582,296,625,411,214,0.553
1583,256.5,702,453,249,0.392
1584,213.5,723,458,265,0.361
1585,27.5,1,1,0,1.997
1586,249.5,725,456,269,0.363
1587,236.25,602,398,204,0.602
1588,268.25,700,454,246,0.392
1589,24.5,0,0,0,2
1590,309.5,726,456,270,0.362
1591,242.75,686,429,257,0.456
1592,224.75,661,424,237,0.491
1593,294.5,638,415,223,0.532
1594,287.25,644,415,229,0.526
1595,49.25,4,3,1,1.99
1596,26.5,1,1,0,1.997
1597,215,697,443,254,0.417
1598,6.5,0,0,0,2
1599,236,689,441,248,0.429
1600,264,651,423,228,0.503
1601,278.5,697,456,241,0.391
1602,242.5,746,461,285,0.332
1603,276.75,671,426,245,0.477
1604,299.25,676,443,233,0.438
1605,369.5,674,444,230,0.438
1606,259,689,436,253,0.439
1607,253.5,693,440,253,0.427
1608,78.75,7,6,1,1.981
1609,366.5,691,437,254,0.435
1610,292.25,671,432,239,0.465
1611,24.25,0,0,0,2
1612,16.25,0,0,0,2
1613,29.25,1,0,1,1.999
1614,282.25,642,418,224,0.522
1615,16.5,0,0,0,2
1616,25,1,1,0,1.997
1617,244.75,693,435,258,0.437
1618,264.5,668,436,232,0.46
1619,367.5,666,425,241,0.484
1620,233,725,457,268,0.361
1621,245,657,443,214,0.457
1622,4.25,0,0,0,2
1623,231.75,721,453,268,0.373
1624,21.75,0,0,0,2
1625,242.5,674,433,241,0.46
1626,224.25,638,414,224,0.534
1627,215.25,678,437,241,0.448
1628,256.5,659,428,231,0.485
1629,19.5,0,0,0,2
1630,206,655,431,224,0.483
1631,351.5,686,431,255,0.452
1632,4.75,0,0,0,2
1633,239,715,440,275,0.405
1634,263.5,683,440,243,0.437
1635,8.5,0,0,0,2
1636,11.75,0,0,0,2
1637,13,0,0,0,2
1638,243.75,672,426,246,0.476
1639,2.75,0,0,0,2
1640,19.75,0,0,0,2
1641,201.25,663,424,239,0.489
1642,235.5,649,424,225,0.503
1643,9,0,0,0,2
1644,7.75,0,0,0,2
1645,262.75,700,445,255,0.41
1646,232,687,435,252,0.443
1647,281,703,455,248,0.387
1648,62.75,8,7,1,1.978
1649,326,674,430,244,0.466
1650,244.75,719,446,273,0.389
1651,282.5,698,447,251,0.408
1652,316.25,680,441,239,0.438
1653,30.25,1,1,0,1.997
1654,17,0,0,0,2
1655,242,642,424,218,0.51
1656,262.25,678,434,244,0.454
1657,12.25,0,0,0,2
1658,266.5,631,422,209,0.525
1659,246.5,671,425,246,0.479
1660,293.25,733,459,274,0.349
1661,266.5,671,426,245,0.477
1662,6.75,0,0,0,2
1663,279.5,647,406,241,0.541
1664,38.25,2,2,0,1.994
1665,303.5,662,412,250,0.514
1666,247.25,675,426,249,0.473
1667,275.75,674,436,238,0.454
1668,302,665,416,249,0.503
1669,15.5,0,0,0,2
1670,276,684,430,254,0.456
1671,267.5,679,435,244,0.451
1672,26.25,0,0,0,2
1673,295.5,731,453,278,0.363
1674,13.75,0,0,0,2
1675,307.75,647,424,223,0.505
1676,245.25,663,432,231,0.473
1677,287.5,677,436,241,0.451
1678,275,681,445,236,0.429
1679,11.25,1,1,0,1.997
1680,7.5,0,0,0,2
1681,76.75,7,4,3,1.985
1682,80,13,12,1,1.963
1683,17.5,0,0,0,2
1684,30,1,1,0,1.997
1685,234.75,695,439,256,0.427
1686,238.25,672,431,241,0.466
1687,43.75,3,3,0,1.991
1688,260,666,437,229,0.46
1689,324.25,672,431,241,0.466
1690,283.75,671,439,232,0.451
1691,54.25,5,3,2,1.989
1692,210,698,440,258,0.422
1693,225,688,444,244,0.424
1694,29.25,0,0,0,2
1695,10.25,0,0,0,2
1696,242,655,423,232,0.499
1697,386.25,652,419,233,0.51
1698,3.75,0,0,0,2
1699,243.25,672,439,233,0.45
1700,329.5,699,441,258,0.419
1701,245,729,444,285,0.383
1702,8.75,0,0,0,2
1703,248,695,441,254,0.423
1704,263.75,691,444,247,0.421
1705,284,651,429,222,0.491
1706,251.25,743,456,287,0.345
1707,290.75,659,424,235,0.493
1708,323.25,677,434,243,0.455
1709,276.5,703,445,258,0.407
1710,201,769,465,304,0.301
1711,272.25,691,435,256,0.439
1712,266.5,660,421,239,0.498
1713,26.25,1,1,0,1.997
1714,267.25,731,449,282,0.371
1715,265.5,664,428,236,0.48
1716,11,0,0,0,2
1717,15,0,0,0,2
1718,252,682,437,245,0.444
1719,262.75,721,450,271,0.379
1720,263.5,686,423,263,0.468
1721,309.5,708,441,267,0.41
1722,330,683,438,245,0.441
1723,296,674,442,232,0.442
1724,215.25,664,424,240,0.488
1725,210.75,656,422,234,0.5
1726,14.5,0,0,0,2
1727,243.75,676,422,254,0.48
1728,274.5,635,424,211,0.517
1729,292.75,708,452,256,0.388
1730,271,698,440,258,0.422
1731,335.75,710,455,255,0.38
1732,18.75,1,1,0,1.997
1733,260.25,600,411,189,0.578
1734,26,3,3,0,1.991
1735,301,678,434,244,0.454
1736,261.75,681,438,243,0.443
1737,10.75,0,0,0,2
1738,267.75,615,414,201,0.557
1739,295.25,689,436,253,0.439
1740,229.5,722,451,271,0.376
1741,208.75,687,440,247,0.433
1742,314.25,645,423,222,0.509
1743,242.25,743,460,283,0.337
1744,287.5,670,422,248,0.486
1745,260,654,419,235,0.508
1746,277.5,682,433,249,0.452
1747,258,743,462,281,0.333
1748,91.75,17,11,6,1.961
1749,314.25,681,447,234,0.425
1750,20,0,0,0,2
1751,296,661,420,241,0.499
1752,263,659,425,234,0.491
1753,14.75,0,0,0,2
1754,289.5,676,425,251,0.474
1755,7.5,0,0,0,2
1756,284.25,692,443,249,0.422
1757,281.75,725,446,279,0.383
1758,290.5,648,410,238,0.532
1759,247,717,447,270,0.389
1760,12.5,0,0,0,2
1761,188.5,647,414,233,0.525
1762,206.25,728,446,282,0.38
1763,331.75,670,426,244,0.478
1764,356,670,437,233,0.456
1765,310.5,674,431,243,0.464
1766,270,664,412,252,0.512
1767,353.25,695,446,249,0.413
1768,3.5,0,0,0,2
1769,5.25,0,0,0,2
1770,314,699,444,255,0.413
1771,308.25,701,434,267,0.431
1772,276,678,432,246,0.458
1773,7.75,0,0,0,2
1774,20.5,0,0,0,2
1775,202,691,438,253,0.433
1776,268,668,430,238,0.472
1777,24.5,1,1,0,1.997
1778,25.25,0,0,0,2
1779,36.25,0,0,0,2
1780,255.5,698,451,247,0.4
1781,7.75,0,0,0,2
1782,15,0,0,0,2
1783,23,1,1,0,1.997
1784,220.5,688,436,252,0.44
1785,245.5,678,426,252,0.47
1786,294,720,447,273,0.386
1787,268.25,668,426,242,0.48
1788,38.5,3,2,1,1.993
1789,291,623,408,215,0.561
1790,249.75,659,422,237,0.497
1791,12.5,0,0,0,2
1792,9.75,0,0,0,2
1793,239,714,452,262,0.382
1794,259,701,446,255,0.407
1795,277.75,644,432,212,0.492
1796,191.25,734,451,283,0.364
1797,32.75,1,1,0,1.997
1798,257.75,667,423,244,0.487
1799,328.25,645,423,222,0.509
1800,245.25,714,440,274,0.406
1801,230.5,746,447,299,0.36
1802,211.5,708,445,263,0.402
1803,222.5,698,436,262,0.43
1804,33.5,2,2,0,1.994
1805,199.5,698,427,271,0.448
1806,4.25,0,0,0,2
1807,252.75,671,430,241,0.469
1808,278.75,694,458,236,0.39
1809,319,640,414,226,0.532
1810,10.5,0,0,0,2
1811,26.75,1,1,0,1.997
1812,14.25,0,0,0,2
1813,293.25,686,439,247,0.436
1814,340,700,433,267,0.434
1815,278.25,673,430,243,0.467
1816,274,606,403,203,0.588
1817,259.5,696,438,258,0.428
1818,217.75,682,428,254,0.462
1819,278,735,455,280,0.355
1820,245,669,422,247,0.487
1821,391,712,447,265,0.394
1822,11.25,0,0,0,2
1823,25.5,1,1,0,1.997
1824,263.25,670,427,243,0.476
1825,11.25,0,0,0,2
1826,250.75,701,438,263,0.423
1827,274.5,753,465,288,0.317
1828,252.5,679,433,246,0.455
1829,231.25,706,446,260,0.402
1830,300.5,667,441,226,0.451
1831,269,691,442,249,0.425
1832,246.5,701,448,253,0.403
1833,25.5,2,2,0,1.994
1834,260.5,660,435,225,0.47
1835,29.25,2,1,1,1.996
1836,32.75,2,2,0,1.994
1837,26.75,0,0,0,2
1838,279.25,696,439,257,0.426
1839,203.5,650,426,224,0.498
1840,266.75,689,444,245,0.423
1841,285,668,423,245,0.486
1842,13.5,0,0,0,2
1843,220.75,678,428,250,0.466
1844,10.5,0,0,0,2
1845,255.75,754,459,295,0.328
1846,240.5,641,425,216,0.509
1847,256.5,636,419,217,0.526
1848,317.75,643,414,229,0.529
1849,224,665,431,234,0.473
1850,31,3,2,1,1.993
1851,281,697,438,259,0.427
1852,251.75,670,416,254,0.498
1853,263.5,756,458,298,0.328
1854,256.5,693,440,253,0.427
1855,242.75,711,442,269,0.405
1856,260.5,652,423,229,0.502
1857,282.75,657,417,240,0.509
1858,55.5,1,1,0,1.997
1859,25.5,1,1,0,1.997
1860,334.75,692,441,251,0.426
1861,250.25,695,441,254,0.423
1862,20.25,0,0,0,2
1863,254.75,676,440,236,0.444
1864,6.75,0,0,0,2
1865,212.5,710,441,269,0.408
1866,432.75,650,414,236,0.522
1867,355.25,709,459,250,0.373
1868,45.5,1,0,1,1.999
1869,22.75,1,1,0,1.997
1870,251,651,425,226,0.499
1871,267.25,700,439,261,0.422
1872,9,0,0,0,2
1873,10.25,0,0,0,2
1874,246.25,702,442,260,0.414
1875,36.75,1,1,0,1.997
1876,250.75,693,434,259,0.439
1877,231,695,434,261,0.437
1878,250.5,714,450,264,0.386
1879,330.25,689,433,256,0.445
1880,336.25,638,404,234,0.554
1881,258.25,697,442,255,0.419
1882,320.5,653,420,233,0.507
1883,5.75,0,0,0,2
1884,4.5,0,0,0,2
1885,204.25,703,442,261,0.413
1886,263.5,650,421,229,0.508
1887,6,0,0,0,2
1888,312.75,721,454,267,0.371
1889,270.5,685,436,249,0.443
1890,261.25,693,426,267,0.455
1891,22.25,1,1,0,1.997
1892,11.25,0,0,0,2
1893,279.75,659,426,233,0.489
1894,317.5,726,448,278,0.378
1895,21.5,0,0,0,2
1896,228.25,738,449,289,0.364
1897,259.5,698,445,253,0.412
1898,19.5,0,0,0,2
1899,257.75,680,441,239,0.438
1900,11.5,0,0,0,2
1901,278.25,682,436,246,0.446
1902,320.25,701,445,256,0.409
1903,193,681,426,255,0.467
1904,293.75,705,451,254,0.393
1905,241.5,673,434,239,0.459
1906,17,1,1,0,1.997
1907,28.25,2,1,1,1.996
1908,326,675,431,244,0.463
1909,276,672,437,235,0.454
1910,238.25,719,437,282,0.407
1911,45.5,4,2,2,1.992
1912,294.75,656,425,231,0.494
1913,247.75,680,433,247,0.454
1914,276.25,671,439,232,0.451
1915,279.75,717,456,261,0.371
1916,28,1,1,0,1.997
1917,80.25,2,2,0,1.994
1918,223.75,688,438,250,0.436
1919,318.5,662,435,227,0.468
1920,219.25,709,445,264,0.401
1921,285,668,433,235,0.466
1922,25.25,1,1,0,1.997
1923,274.25,697,448,249,0.407
1924,326.5,638,435,203,0.492
1925,21.75,0,0,0,2
1926,251.75,613,403,210,0.581
1927,19,0,0,0,2
1928,261.75,645,423,222,0.509
1929,17.5,0,0,0,2
1930,304.75,665,435,230,0.465
1931,266,639,414,225,0.533
1932,363.5,729,457,272,0.357
1933,243.5,686,434,252,0.446
1934,392.75,684,437,247,0.442
1935,38.5,8,8,0,1.976
1936,257.25,680,443,237,0.434
1937,5.5,0,0,0,2
1938,318.5,697,438,259,0.427
1939,51.5,2,1,1,1.996
1940,243,722,446,276,0.386
1941,280.25,723,448,275,0.381
1942,6.5,0,0,0,2
1943,10.75,0,0,0,2
1944,234.75,698,447,251,0.408
1945,203.75,694,446,248,0.414
1946,26.25,0,0,0,2
1947,263.5,671,435,236,0.459
1948,287.5,720,456,264,0.368
1949,279.5,669,438,231,0.455
1950,316,669,433,236,0.465
1951,8.5,0,0,0,2
1952,237,698,441,257,0.42
1953,206.75,681,437,244,0.445
1954,326.75,675,431,244,0.463
1955,334.75,707,443,264,0.407
1956,23,0,0,0,2
1957,245,689,455,234,0.401
1958,272.75,721,433,288,0.413
1959,256.25,681,428,253,0.463
1960,313.5,678,431,247,0.46
1961,68,5,3,2,1.989
1962,287.5,645,432,213,0.491
1963,307.5,697,438,259,0.427
1964,290.75,695,444,251,0.417
1965,249.5,674,431,243,0.464
1966,269.25,621,406,215,0.567
1967,12.25,0,0,0,2
1968,240.25,665,419,246,0.497
1969,15.75,0,0,0,2
1970,265.5,676,429,247,0.466
1971,326.5,672,426,246,0.476
1972,270.75,694,433,261,0.44
1973,24.75,0,0,0,2
1974,18,0,0,0,2
1975,271.75,721,451,270,0.377
1976,10,0,0,0,2
1977,37,1,1,0,1.997
1978,51.75,1,0,1,1.999
1979,10,0,0,0,2
1980,322.5,687,427,260,0.459
1981,227.25,692,432,260,0.444
1982,6.25,0,0,0,2
1983,19.5,1,1,0,1.997
1984,284.5,705,448,257,0.399
1985,253,690,444,246,0.422
1986,268.5,698,441,257,0.42
1987,231.25,697,442,255,0.419
1988,5.75,0,0,0,2
1989,234,688,443,245,0.426
1990,5.25,0,0,0,2
1991,263.75,645,416,229,0.523
1992,268.25,673,433,240,0.461
1993,258.75,723,460,263,0.357
1994,234,725,441,284,0.393
1995,215,678,440,238,0.442
1996,65,3,2,1,1.993
1997,9,0,0,0,2
1998,12.5,0,0,0,2
1999,7.75,0,0,0,2
2000,365,681,430,251,0.459
2001,321,707,447,260,0.399
2002,266.75,671,427,244,0.475
2003,8.5,0,0,0,2
2004,10.5,0,0,0,2
2005,17.75,0,0,0,2
2006,276,674,435,239,0.456
2007,10.5,0,0,0,2
2008,213,712,448,264,0.392
2009,41,3,2,1,1.993
2010,246.5,673,432,241,0.463
2011,315.75,638,418,220,0.526
2012,293.5,652,422,230,0.504
2013,32.75,1,1,0,1.997
2014,257.5,647,423,224,0.507
2015,29.75,0,0,0,2
2016,254.75,653,416,237,0.515
2017,66.25,2,2,0,1.994
2018,226.75,655,419,236,0.507
2019,261.75,662,433,229,0.472
2020,221.75,669,431,238,0.469
2021,4.5,0,0,0,2
2022,10.75,0,0,0,2
2023,8.75,0,0,0,2
2024,246,671,435,236,0.459
2025,271.25,656,424,232,0.496
2026,217.5,685,440,245,0.435
2027,237.5,720,449,271,0.382
2028,201,685,438,247,0.439
2029,67,4,3,1,1.99
2030,209.5,701,443,258,0.413
2031,295,660,436,224,0.468
2032,250.75,641,412,229,0.535
2033,249.5,711,444,267,0.401
2034,247,676,436,240,0.452
2035,317,688,434,254,0.444
2036,7.75,0,0,0,2
2037,232.5,701,456,245,0.387
2038,15,0,0,0,2
2039,291.25,686,437,249,0.44
2040,40,3,2,1,1.993
2041,8.25,0,0,0,2
2042,44.75,2,2,0,1.994
2043,22.75,0,0,0,2
2044,272.5,631,420,211,0.529
2045,10.5,0,0,0,2
2046,16.75,1,1,0,1.997
2047,30.75,2,1,1,1.996
2048,11.25,0,0,0,2
2049,6,0,0,0,2
2050,313.25,669,434,235,0.463
2051,331,614,404,210,0.578
2052,12,0,0,0,2
2053,35,3,2,1,1.993
2054,250.75,693,441,252,0.425
2055,285.25,681,446,235,0.427
2056,307,618,410,208,0.562
2057,243.25,743,466,277,0.325
2058,258,692,438,254,0.432
2059,88.5,19,15,4,1.951
2060,246.25,670,429,241,0.472
2061,259.75,690,441,249,0.428
2062,248.25,677,434,243,0.455
2063,17.5,0,0,0,2
2064,13.75,0,0,0,2
2065,265.75,692,444,248,0.42
2066,303.25,689,441,248,0.429
2067,7.25,0,0,0,2
2068,261.25,638,416,222,0.53
2069,42.5,3,2,1,1.993
2070,252,670,425,245,0.48
2071,237.75,664,432,232,0.472
2072,289.5,725,452,273,0.371
2073,267,712,456,256,0.376
2074,249.75,693,445,248,0.417
2075,328.75,680,431,249,0.458
2076,233.25,695,444,251,0.417
2077,16,1,0,1,1.999
2078,316.5,692,438,254,0.432
2079,315,719,450,269,0.381
2080,281.5,691,433,258,0.443
2081,249.75,692,441,251,0.426
2082,5,0,0,0,2
2083,252.75,639,414,225,0.533
2084,224.25,658,419,239,0.504
2085,87.75,4,4,0,1.988
2086,286,630,408,222,0.554
2087,35.25,1,1,0,1.997
2088,291.5,664,430,234,0.476
2089,235.75,695,451,244,0.403
2090,250.5,693,435,258,0.437
2091,47.75,2,2,0,1.994
2092,14.5,0,0,0,2
2093,14.5,0,0,0,2
2094,52.25,5,3,2,1.989
2095,13.75,0,0,0,2
2096,304.5,689,438,251,0.435
2097,284.25,689,444,245,0.423
2098,255,679,435,244,0.451
2099,248.75,704,444,260,0.408
2100,273,695,440,255,0.425
2101,246.75,724,453,271,0.37
2102,258.25,703,441,262,0.415
2103,257,682,433,249,0.452
2104,273,694,449,245,0.408
2105,13.75,0,0,0,2
2106,283.5,654,427,227,0.492
2107,255.75,717,449,268,0.385
2108,13,0,0,0,2
2109,234.75,721,452,269,0.375
2110,312.5,688,436,252,0.44
2111,249.75,666,432,234,0.47
2112,292,640,411,229,0.538
2113,17.5,1,1,0,1.997
2114,278.75,646,431,215,0.492
2115,19.25,0,0,0,2
2116,247.25,696,437,259,0.43
2117,13.75,0,0,0,2
2118,227.75,687,432,255,0.449
2119,16.5,0,0,0,2
2120,32.5,2,2,0,1.994
2121,281.25,699,442,257,0.417
2122,18.25,0,0,0,2
2123,218.5,651,415,236,0.519
2124,235.5,681,438,243,0.443
2125,311.75,706,434,272,0.426
2126,333.5,697,444,253,0.415
2127,318.75,652,418,234,0.512
2128,370,607,412,195,0.569
2129,298.75,655,421,234,0.503
2130,222,696,426,270,0.452
2131,28.75,0,0,0,2
2132,243.75,675,437,238,0.451
2133,250,705,444,261,0.407
2134,219.5,716,447,269,0.39
2135,304.75,692,446,246,0.416
2136,10.75,0,0,0,2
2137,315.25,662,430,232,0.478
2138,25.5,0,0,0,2
2139,217.25,740,459,281,0.342
2140,311.25,697,437,260,0.429
2141,252.25,669,440,229,0.451
2142,235.25,716,443,273,0.398
2143,222.25,655,429,226,0.487
2144,264.5,653,427,226,0.493
2145,202.5,696,445,251,0.414
2146,267.25,692,431,261,0.446
2147,273.5,739,458,281,0.345
2148,240.25,671,430,241,0.469
2149,9.5,0,0,0,2
2150,278,678,431,247,0.46
2151,9.25,0,0,0,2
2152,220,711,451,260,0.387
2153,11.5,0,0,0,2
2154,12.75,0,0,0,2
2155,280.5,669,430,239,0.471
2156,30.75,2,2,0,1.994
2157,217.25,712,445,267,0.398
2158,229.75,650,430,220,0.49
2159,256.25,667,444,223,0.445
2160,286.5,693,450,243,0.407
2161,23.5,0,0,0,2
2162,332,630,423,207,0.524
2163,223.75,683,446,237,0.425
2164,233.5,705,442,263,0.411
2165,285.5,731,445,286,0.379
2166,308.75,663,435,228,0.467
2167,284,649,427,222,0.497
2168,298.75,708,447,261,0.398
2169,286,690,434,256,0.442
2170,238.75,692,449,243,0.41
2171,232.25,703,444,259,0.409
2172,9.75,0,0,0,2
2173,8,0,0,0,2
2174,211,663,435,228,0.467
2175,301,691,442,249,0.425
2176,313.25,667,434,233,0.465
2177,15.25,1,0,1,1.999
2178,292.5,604,396,208,0.604
2179,40.75,1,1,0,1.997
2180,311.5,672,437,235,0.454
2181,323.75,698,428,270,0.446
2182,218,702,458,244,0.382
2183,208.25,649,419,230,0.513
2184,248,670,430,240,0.47
2185,209.5,730,456,274,0.358
2186,15.25,0,0,0,2
2187,255.75,695,447,248,0.411
2188,6.25,0,0,0,2
2189,296.5,691,445,246,0.419
2190,224.75,712,444,268,0.4
2191,300,659,434,225,0.473
2192,8.25,0,0,0,2
2193,41,4,4,0,1.988
2194,47.75,2,1,1,1.996
2195,268.75,667,429,238,0.475
2196,220,720,461,259,0.358
2197,255.5,681,443,238,0.433
2198,19.5,0,0,0,2
2199,277.75,714,446,268,0.394
2200,20.75,0,0,0,2
2201,264.5,692,443,249,0.422
2202,221,676,429,247,0.466
2203,22,0,0,0,2
2204,294.5,703,431,272,0.435
2205,17,1,0,1,1.999
2206,259.25,731,462,269,0.345
2207,235.25,671,438,233,0.453
2208,327.5,716,458,258,0.368
2209,278,647,414,233,0.525
2210,323.25,698,448,250,0.406
2211,235.25,672,429,243,0.47
2212,8.25,0,0,0,2
2213,16,0,0,0,2
2214,305.75,684,428,256,0.46
2215,261.75,673,433,240,0.461
2216,250.75,707,439,268,0.415
2217,9.5,0,0,0,2
2218,9.25,0,0,0,2
2219,232.75,617,401,216,0.581
2220,312.75,607,423,184,0.547
2221,25.5,1,1,0,1.997
2222,6,0,0,0,2
2223,283.5,668,427,241,0.478
2224,17.5,0,0,0,2
2225,221,707,438,269,0.417
2226,9.75,0,0,0,2
2227,233.75,682,422,260,0.474
2228,12.5,0,0,0,2
2229,304.25,656,426,230,0.492
2230,253.5,722,450,272,0.378
2231,260.75,643,409,234,0.539
2232,260.5,695,438,257,0.429
2233,326.75,735,461,274,0.343
2234,39,3,3,0,1.991
2235,58,6,3,3,1.988
2236,20.5,1,1,0,1.997
2237,231.5,680,435,245,0.45
2238,11,0,0,0,2
2239,25,1,1,0,1.997
2240,246.75,700,445,255,0.41
2241,325.25,729,458,271,0.355
2242,20.25,0,0,0,2
2243,28.75,0,0,0,2
2244,234.75,691,439,252,0.431
2245,273.5,658,433,225,0.476
2246,43.75,2,1,1,1.996
2247,241.75,615,403,212,0.579
2248,267.5,692,431,261,0.446
2249,238.25,736,451,285,0.362
2250,268.5,641,409,232,0.541
2251,256.5,659,414,245,0.513
2252,243.75,655,428,227,0.489
2253,229.75,625,401,224,0.573
2254,274.5,662,438,224,0.462
2255,299,694,437,257,0.432
2256,251.75,685,428,257,0.459
2257,186.25,630,428,202,0.514
2258,16.75,0,0,0,2
2259,28.5,0,0,0,2
2260,70.25,13,10,3,1.967
2261,9.5,0,0,0,2
2262,287.5,681,447,234,0.425
2263,288,733,456,277,0.355
2264,36.25,0,0,0,2
2265,303.25,686,438,248,0.438
2266,327.25,702,443,259,0.412
2267,21.25,1,1,0,1.997
2268,10,0,0,0,2
2269,255.25,680,426,254,0.468
2270,253.75,678,425,253,0.472
2271,240.25,688,439,249,0.434
2272,38.5,4,2,2,1.992
2273,31.25,0,0,0,2
2274,16.25,0,0,0,2
2275,292.5,703,441,262,0.415
2276,54,2,2,0,1.994
2277,257,667,432,235,0.469
2278,251,663,435,228,0.467
2279,253.75,710,442,268,0.406
2280,229.25,703,441,262,0.415
2281,52.25,2,1,1,1.996
2282,287.25,658,416,242,0.51
2283,13.75,0,0,0,2
2284,384,659,432,227,0.477
2285,264,686,441,245,0.432
2286,15.5,0,0,0,2
2287,13.5,0,0,0,2
2288,277.75,679,441,238,0.439
2289,14,0,0,0,2
2290,235.75,709,433,276,0.425
2291,60.25,6,5,1,1.984
2292,308.5,622,409,213,0.56
2293,286.75,658,429,229,0.484
2294,311.75,681,437,244,0.445
2295,239.25,687,438,249,0.437
2296,266.75,681,427,254,0.465
2297,20,0,0,0,2
2298,354.5,720,453,267,0.374
2299,229.75,647,430,217,0.493
2300,256.75,645,415,230,0.525
2301,264.5,696,437,259,0.43
2302,249,667,423,244,0.487
2303,47.25,4,3,1,1.99
2304,258,701,443,258,0.413
2305,70.75,4,3,1,1.99
2306,325.25,658,423,235,0.496
2307,70,5,2,3,1.991
2308,62.25,4,3,1,1.99
2309,254.25,709,446,263,0.399
2310,214.75,731,457,274,0.355
2311,259.25,646,417,229,0.52
2312,234.5,702,450,252,0.398
2313,11.5,0,0,0,2
2314,19.25,0,0,0,2
2315,62.75,5,5,0,1.985
2316,301.5,644,407,237,0.542
2317,262.5,742,467,275,0.324
2318,278,672,438,234,0.452
2319,242.25,697,442,255,0.419
2320,243.25,668,434,234,0.464
2321,264.75,725,451,274,0.373
2322,252.25,651,423,228,0.503
2323,32.5,0,0,0,2
2324,272.5,659,423,236,0.495
2325,188.5,709,442,267,0.407
2326,33,2,2,0,1.994
2327,276.25,640,413,227,0.534
2328,29.5,3,2,1,1.993
2329,276.25,683,419,264,0.479
2330,40.5,2,1,1,1.996
2331,287.5,691,454,237,0.401
2332,291.25,698,447,251,0.408
2333,11.75,0,0,0,2
2334,224.5,667,424,243,0.485
2335,253.25,711,446,265,0.397
2336,262,693,444,249,0.419
2337,265.25,652,423,229,0.502
2338,29.25,1,0,1,1.999
2339,40.25,1,1,0,1.997
2340,11.75,0,0,0,2
2341,241.75,676,430,246,0.464
2342,239,620,403,217,0.574
2343,306.5,654,424,230,0.498
2344,267.5,636,419,217,0.526
2345,233.5,628,424,204,0.524
2346,262.75,704,448,256,0.4
2347,209,640,418,222,0.524
2348,59.5,3,3,0,1.991
2349,253,638,414,224,0.534
2350,242,649,419,230,0.513
2351,31,1,1,0,1.997
2352,13.25,1,1,0,1.997
2353,241,645,411,234,0.533
2354,14.5,1,1,0,1.997
2355,7,0,0,0,2
2356,258.5,667,437,230,0.459
2357,280.5,674,437,237,0.452
2358,282.5,679,446,233,0.429
2359,282.25,707,445,262,0.403
2360,249.75,685,436,249,0.443
2361,13.5,1,1,0,1.997
2362,37.75,0,0,0,2
2363,289.75,680,443,237,0.434
2364,12.25,0,0,0,2
2365,8,0,0,0,2
2366,13.5,0,0,0,2
2367,240.75,646,429,217,0.496
2368,239.25,705,439,266,0.417
2369,313.75,628,415,213,0.542
2370,267.75,669,421,248,0.489
2371,272.75,673,428,245,0.471
2372,237.25,664,424,240,0.488
2373,220.75,683,432,251,0.453
2374,11.75,1,1,0,1.997
2375,225.5,677,443,234,0.437
2376,326.25,643,416,227,0.525
2377,359,705,451,254,0.393
2378,309.25,692,447,245,0.414
2379,257,636,408,228,0.548
2380,297,655,414,241,0.517
2381,229.75,663,439,224,0.459
2382,214.75,663,431,232,0.475
2383,206.5,683,435,248,0.447
2384,88,4,3,1,1.99
2385,7,0,0,0,2
2386,355.25,648,422,226,0.508
2387,291.75,668,437,231,0.458
2388,217.75,704,448,256,0.4
2389,71.5,5,4,1,1.987
2390,23.25,0,0,0,2
2391,55.5,5,5,0,1.985
2392,217.5,644,409,235,0.538
2393,7.5,0,0,0,2
2394,254.25,695,434,261,0.437
2395,327.5,699,442,257,0.417
2396,298,701,448,253,0.403
2397,244.25,673,423,250,0.481
2398,266.25,669,431,238,0.469
2399,278.25,668,433,235,0.466
2400,19,0,0,0,2
2401,34.5,1,1,0,1.997
2402,36.25,1,1,0,1.997
2403,19.25,1,1,0,1.997
2404,249.75,693,443,250,0.421
2405,320,693,431,262,0.445
2406,319.25,659,433,226,0.475
2407,292.25,729,451,278,0.369
2408,353.75,692,438,254,0.432
2409,347.25,622,397,225,0.584
2410,279.25,652,415,237,0.518
2411,31.75,1,1,0,1.997
2412,71.75,8,5,3,1.982
2413,274.25,661,423,238,0.493
2414,12.5,1,1,0,1.997
2415,9,0,0,0,2
2416,296.25,672,429,243,0.47
2417,23.75,1,1,0,1.997
2418,17.25,0,0,0,2
2419,288.5,685,422,263,0.471
2420,272.75,672,433,239,0.462
2421,349.5,692,442,250,0.424
2422,231,722,453,269,0.372
2423,329.25,714,437,277,0.412
2424,6,0,0,0,2
2425,232.25,682,432,250,0.454
2426,15.25,0,0,0,2
2427,15,0,0,0,2
2428,232.75,657,417,240,0.509
2429,240.25,691,449,242,0.411
2430,5.75,0,0,0,2
2431,259,648,425,223,0.502
2432,266.5,699,449,250,0.403
2433,13.75,0,0,0,2
2434,270.25,718,452,266,0.378
2435,239.75,682,433,249,0.452
2436,243,683,430,253,0.457
2437,271.75,676,438,238,0.448
2438,295.5,667,432,235,0.469
2439,9.25,0,0,0,2
2440,8.75,0,0,0,2
2441,11,0,0,0,2
2442,13.75,0,0,0,2
2443,11,0,0,0,2
2444,317.25,684,446,238,0.424
2445,278.25,710,449,261,0.392
2446,277.25,683,428,255,0.461
2447,16.75,0,0,0,2
2448,32.5,0,0,0,2
2449,245.5,694,446,248,0.414
2450,247,676,445,231,0.434
2451,231.75,676,432,244,0.46
2452,27.5,0,0,0,2
2453,187,663,427,236,0.483
2454,248.75,704,458,246,0.38
2455,247.5,679,430,249,0.461
2456,320.5,686,443,243,0.428
2457,124.5,6,2,4,1.99
2458,226.5,683,433,250,0.451
2459,213.5,700,444,256,0.412
2460,307.5,676,435,241,0.454
2461,301.5,657,426,231,0.491
2462,26.25,0,0,0,2
2463,252,730,446,284,0.378
2464,236.25,718,452,266,0.378
2465,12.5,0,0,0,2
2466,348.5,703,452,251,0.393
2467,193.5,651,411,240,0.527
2468,13.75,0,0,0,2
2469,300.5,664,424,240,0.488
2470,28,2,2,0,1.994
2471,8,0,0,0,2
2472,242,705,441,264,0.413
2473,218.75,695,443,252,0.419
2474,42.75,4,3,1,1.99
2475,247.5,722,449,273,0.38
2476,23.5,2,0,2,1.998
2477,335.25,708,446,262,0.4
2478,45.75,4,3,1,1.99
2479,264.75,680,437,243,0.446
2480,36.5,1,1,0,1.997
2481,280,698,441,257,0.42
2482,238,709,446,263,0.399
2483,52,5,2,3,1.991
2484,7.75,0,0,0,2
2485,286.25,704,438,266,0.42
2486,9,0,0,0,2
2487,17.5,0,0,0,2
2488,27.5,0,0,0,2
2489,258,664,424,240,0.488
2490,325,730,449,281,0.372
2491,309.75,675,424,251,0.477
2492,7,0,0,0,2
2493,260.25,652,421,231,0.506
2494,278,658,422,236,0.498
2495,262.5,713,457,256,0.373
2496,216.5,602,400,202,0.598
2497,16,0,0,0,2
2498,14,0,0,0,2
2499,220.75,672,435,237,0.458
2500,203.25,679,433,246,0.455
2501,292.25,657,419,238,0.505
2502,286,648,422,226,0.508
2503,15.5,2,2,0,1.994
2504,245,665,423,242,0.489
2505,262.25,665,429,236,0.477
2506,241.75,638,422,216,0.518
2507,274,614,401,213,0.584
2508,297,682,429,253,0.46
2509,278.5,690,449,241,0.412
2510,248,689,441,248,0.429
2511,207.75,684,454,230,0.408
2512,271.25,734,449,285,0.368
2513,295,683,433,250,0.451
2514,10.75,0,0,0,2
2515,279.75,652,428,224,0.492
2516,344.25,683,437,246,0.443
2517,243,645,412,233,0.531
2518,29.75,1,0,1,1.999
2519,246,710,449,261,0.392
2520,266,696,443,253,0.418
2521,259,677,433,244,0.457
2522,324.75,709,451,258,0.389
2523,23.5,0,0,0,2
2524,273.75,696,433,263,0.438
2525,216.25,667,431,236,0.471
2526,8,0,0,0,2
2527,306.75,662,423,239,0.492
2528,261,680,435,245,0.45
2529,265.75,685,433,252,0.449
2530,35.5,1,1,0,1.997
2531,8.25,0,0,0,2
2532,381.5,670,441,229,0.448
2533,16.5,0,0,0,2
2534,79,6,6,0,1.982
2535,341.25,702,449,253,0.4
2536,251.25,667,433,234,0.467
2537,25.25,1,1,0,1.997
2538,32,0,0,0,2
2539,235.5,684,437,247,0.442
2540,238,677,440,237,0.443
2541,28.25,2,1,1,1.996
2542,256.5,685,449,236,0.417
2543,57.75,4,3,1,1.99
2544,9.5,0,0,0,2
2545,352.5,704,445,259,0.406
2546,336.25,691,444,247,0.421
2547,6,0,0,0,2
2548,6.25,0,0,0,2
2549,217.5,678,444,234,0.434
2550,68.75,5,3,2,1.989
2551,299.25,670,435,235,0.46
2552,194.5,707,440,267,0.413
2553,368.75,650,422,228,0.506
2554,222.75,643,423,220,0.511
2555,328.5,684,424,260,0.468
2556,13.5,0,0,0,2
2557,302,670,427,243,0.476
2558,204.75,641,419,222,0.521
2559,326.5,676,441,235,0.442
2560,344.75,697,442,255,0.419
2561,6.5,0,0,0,2
2562,325,681,442,239,0.435
2563,349,655,439,216,0.467
2564,287.25,654,433,221,0.48
2565,15.25,1,0,1,1.999
2566,219.75,669,435,234,0.461
2567,267,624,406,218,0.564
2568,11,0,0,0,2
2569,208.75,705,446,259,0.403
2570,9.25,0,0,0,2
2571,309,706,449,257,0.396
2572,13,0,0,0,2
2573,12.5,0,0,0,2
2574,241.25,686,438,248,0.438
2575,245,727,453,274,0.367
2576,315,684,447,237,0.422
2577,17.5,0,0,0,2
2578,263.75,674,433,241,0.46
2579,278.25,660,430,230,0.48
2580,263.75,630,405,225,0.56
2581,282.75,716,447,269,0.39
2582,15.75,0,0,0,2
2583,265.5,635,415,220,0.535
2584,259,690,429,261,0.452
2585,251.25,705,445,260,0.405
2586,264.25,680,434,246,0.452
2587,292,653,429,224,0.489
2588,298,698,448,250,0.406
2589,340,652,418,234,0.512
2590,277.5,703,453,250,0.391
2591,27.75,2,2,0,1.994
2592,250,671,430,241,0.469
2593,20,0,0,0,2
2594,259.75,728,455,273,0.362
2595,221.25,695,441,254,0.423
2596,16.5,0,0,0,2
2597,2.25,0,0,0,2
2598,232.5,683,443,240,0.431
2599,7.25,0,0,0,2
2600,281.75,653,425,228,0.497
2601,35.75,2,0,2,1.998
2602,237.5,686,434,252,0.446
2603,334.75,673,428,245,0.471
2604,8.75,0,0,0,2
2605,274.75,696,440,256,0.424
2606,272.5,677,437,240,0.449
2607,315.5,722,440,282,0.398
2608,272.5,685,434,251,0.447
2609,296.25,637,412,225,0.539
2610,277.5,673,452,221,0.423
2611,285,685,429,256,0.457
2612,276.75,688,444,244,0.424
2613,223.25,664,428,236,0.48
2614,25.25,3,2,1,1.993
2615,322.5,685,433,252,0.449
2616,251.75,668,429,239,0.474
2617,41,2,2,0,1.994
2618,210.5,682,434,248,0.45
2619,23.25,1,1,0,1.997
2620,291,728,441,287,0.39
2621,254.75,656,433,223,0.478
2622,271.75,676,434,242,0.456
2623,294.25,734,456,278,0.354
2624,237.25,675,436,239,0.453
2625,9,0,0,0,2
2626,318.75,681,436,245,0.447
2627,361.75,658,431,227,0.48
2628,335.25,656,428,228,0.488
2629,217.5,688,434,254,0.444
2630,24.5,1,1,0,1.997
2631,267.5,633,414,219,0.539
2632,9.25,0,0,0,2
2633,242.75,686,439,247,0.436
2634,16,3,2,1,1.993
2635,282.25,644,407,237,0.542
2636,310.75,688,436,252,0.44
2637,318.5,665,420,245,0.495
2638,275,667,427,240,0.479
2639,285,687,446,241,0.421
2640,287,640,410,230,0.54
2641,7.75,0,0,0,2
2642,280.75,603,413,190,0.571
2643,82.25,9,4,5,1.983
2644,42.25,5,4,1,1.987
2645,297.75,672,422,250,0.484
2646,275.75,682,435,247,0.448
2647,8.75,0,0,0,2
2648,25.5,1,1,0,1.997
2649,289.5,684,434,250,0.448
2650,278,694,441,253,0.424
2651,251.75,643,414,229,0.529
2652,251.5,677,436,241,0.451
2653,24.5,0,0,0,2
2654,276.75,694,440,254,0.426
2655,8,0,0,0,2
2656,25.75,3,3,0,1.991
2657,265.75,639,421,218,0.519
2658,38.25,3,3,0,1.991
2659,245,703,451,252,0.395
2660,277.25,730,459,271,0.352
2661,23,0,0,0,2
2662,261.75,654,424,230,0.498
2663,264.5,712,454,258,0.38
2664,10.5,0,0,0,2
2665,59.5,3,2,1,1.993
2666,302.5,668,434,234,0.464
2667,10,0,0,0,2
2668,305.25,657,416,241,0.511
2669,230.25,752,458,294,0.332
2670,264.25,685,433,252,0.449
2671,10.5,0,0,0,2
2672,224.75,666,438,228,0.458
2673,8.5,0,0,0,2
2674,287.75,722,454,268,0.37
2675,267.25,652,421,231,0.506
2676,273.75,687,446,241,0.421
2677,197,685,438,247,0.439
2678,35.75,2,2,0,1.994
2679,305.5,678,436,242,0.45
2680,300,655,420,235,0.505
2681,328.75,641,412,229,0.535
2682,42.25,4,4,0,1.988
2683,10,0,0,0,2
2684,251.25,632,410,222,0.548
2685,232.75,711,445,266,0.399
2686,13.25,0,0,0,2
2687,254.5,673,425,248,0.477
2688,7.75,0,0,0,2
2689,277.75,642,421,221,0.516
2690,292.25,650,407,243,0.536
2691,225,672,430,242,0.468
2692,278,748,452,296,0.348
2693,298,627,400,227,0.573
2694,275,710,448,262,0.394
2695,17.25,1,1,0,1.997
2696,11.25,0,0,0,2
2697,36.5,1,1,0,1.997
2698,10.5,0,0,0,2
2699,12.5,1,1,0,1.997
2700,61.75,6,5,1,1.984
2701,347.75,728,457,271,0.358
2702,12.75,0,0,0,2
2703,311,688,445,243,0.422
2704,8.25,0,0,0,2
2705,214.25,670,417,253,0.496
2706,14.25,0,0,0,2
2707,8.75,0,0,0,2
2708,296.25,743,459,284,0.339
2709,5.25,0,0,0,2
2710,13.75,0,0,0,2
2711,68.75,4,2,2,1.992
2712,209.5,692,447,245,0.414
2713,236,660,425,235,0.49
2714,232,699,439,260,0.423
2715,46.25,0,0,0,2
2716,311,695,444,251,0.417
2717,259.25,715,443,272,0.399
2718,237.25,709,439,270,0.413
2719,6,0,0,0,2
2720,248,710,446,264,0.398
2721,283,665,428,237,0.479
2722,296.25,725,441,284,0.393
2723,14,0,0,0,2
2724,276.25,708,463,245,0.366
2725,39,0,0,0,2
2726,222.5,686,433,253,0.448
2727,245,666,429,237,0.476
2728,258.5,707,452,255,0.389
2729,242.25,694,435,259,0.436
2730,305,693,437,256,0.433
2731,38.5,1,1,0,1.997
2732,4.25,0,0,0,2
2733,335,696,437,259,0.43
2734,239.5,685,437,248,0.441
2735,243,673,428,245,0.471
2736,22.25,0,0,0,2
2737,262,686,429,257,0.456
2738,248.25,696,443,253,0.418
2739,254.5,648,407,241,0.538
2740,303,688,436,252,0.44
2741,310.5,652,424,228,0.5
2742,301.25,739,452,287,0.357
2743,223.5,766,468,298,0.298
2744,11,0,0,0,2
2745,6.25,0,0,0,2
2746,457.5,677,438,239,0.447
2747,22.5,0,0,0,2
2748,291.25,667,430,237,0.473
2749,259.25,686,442,244,0.43
2750,290.5,681,426,255,0.467
2751,36.5,2,2,0,1.994
2752,38.75,1,1,0,1.997
2753,15.5,1,1,0,1.997
2754,276.75,693,441,252,0.425
2755,216.75,707,446,261,0.401
2756,277,694,445,249,0.416
2757,230.25,650,416,234,0.518
2758,247.25,659,431,228,0.479
2759,19,0,0,0,2
2760,15.5,0,0,0,2
2761,218.5,700,442,258,0.416
2762,237.25,703,443,260,0.411
2763,263,664,432,232,0.472
2764,17.25,0,0,0,2
2765,248,737,456,281,0.351
2766,281.25,701,447,254,0.405
2767,275.75,688,437,251,0.438
2768,226.5,672,427,245,0.474
2769,246.75,677,434,243,0.455
2770,305.75,695,439,256,0.427
2771,265.75,678,432,246,0.458
2772,7.5,0,0,0,2
2773,251.75,667,436,231,0.461
2774,242.75,669,430,239,0.471
2775,268.75,699,434,265,0.433
2776,30,1,1,0,1.997
2777,239.25,676,429,247,0.466
2778,252,696,433,263,0.438
2779,270.75,697,445,252,0.413
2780,24,0,0,0,2
2781,309.5,640,416,224,0.528
2782,18,0,0,0,2
2783,9,0,0,0,2
2784,356.25,704,439,265,0.418
2785,287.25,679,447,232,0.427
2786,307.25,654,430,224,0.486
2787,274.25,600,398,202,0.604
2788,256,688,440,248,0.432
2789,60.5,4,4,0,1.988
2790,217,646,421,225,0.512
2791,298.75,704,454,250,0.388
2792,293,687,440,247,0.433
2793,19.25,0,0,0,2
2794,267.25,731,459,272,0.351
2795,12.5,0,0,0,2
2796,243.75,692,445,247,0.418
2797,239.5,702,432,270,0.434
2798,24.5,0,0,0,2
2799,74,7,3,4,1.987
2800,253.5,651,413,238,0.523
2801,316.25,667,432,235,0.469
2802,8.5,0,0,0,2
2803,241.25,682,440,242,0.438
2804,271.5,707,443,264,0.407
2805,297.5,704,447,257,0.402
2806,302.75,709,446,263,0.399
2807,277.5,672,439,233,0.45
2808,254,752,462,290,0.324
2809,380.25,698,445,253,0.412
2810,17,1,1,0,1.997
2811,298.5,629,426,203,0.519
2812,293.75,684,429,255,0.458
2813,19,0,0,0,2
2814,50,3,3,0,1.991
2815,303,665,432,233,0.471
2816,18.75,0,0,0,2
2817,324.75,659,426,233,0.489
2818,224.5,677,425,252,0.473
2819,8,0,0,0,2
2820,263.5,677,429,248,0.465
2821,13.75,0,0,0,2
2822,26.5,0,0,0,2
2823,248.5,726,441,285,0.392
2824,287.75,668,432,236,0.468
2825,264.5,698,436,262,0.43
2826,30,3,3,0,1.991
2827,371.75,683,440,243,0.437
2828,11.25,0,0,0,2
2829,44.25,3,3,0,1.991
2830,18.5,0,0,0,2
2831,257.5,673,442,231,0.443
2832,40,2,1,1,1.996
2833,336.5,682,438,244,0.442
2834,257,671,432,239,0.465
2835,272,704,437,267,0.422
2836,288,704,440,264,0.416
2837,334.25,724,441,283,0.394
2838,23.5,0,0,0,2
2839,264.25,704,445,259,0.406
2840,293.5,636,419,217,0.526
2841,304.25,727,448,279,0.377
2842,7.75,0,0,0,2
2843,320.75,703,447,256,0.403
2844,234.5,727,455,272,0.363
2845,247,715,450,265,0.385
2846,217.75,680,424,256,0.472
2847,108,6,6,0,1.982
2848,295.5,656,432,224,0.48
2849,290,694,436,258,0.434
2850,286.75,668,435,233,0.462
2851,275.5,640,424,216,0.512
2852,276,730,452,278,0.366
2853,236.5,697,451,246,0.401
2854,380.75,693,438,255,0.431
2855,227.25,684,445,239,0.426
2856,289,697,442,255,0.419
2857,255.5,661,428,233,0.483
2858,9.25,0,0,0,2
2859,35,2,2,0,1.994
2860,332,680,442,238,0.436
2861,243.75,696,441,255,0.422
2862,28.25,0,0,0,2
2863,243.75,642,422,220,0.514
2864,230.25,678,434,244,0.454
2865,308.75,692,451,241,0.406
2866,328.5,728,446,282,0.38
2867,14.5,1,0,1,1.999
2868,230.5,623,408,215,0.561
2869,305,696,442,254,0.42
2870,286.75,721,453,268,0.373
2871,18.5,0,0,0,2
2872,281,783,476,307,0.265
2873,10.25,0,0,0,2
2874,54.5,6,4,2,1.986
2875,15,0,0,0,2
2876,20.75,0,0,0,2
2877,353,675,434,241,0.457
2878,243.5,701,451,250,0.397
2879,271.25,633,414,219,0.539
2880,23.5,0,0,0,2
2881,20.25,0,0,0,2
2882,219.5,738,453,285,0.356
2883,315.5,648,430,218,0.492
2884,8.25,0,0,0,2
2885,18.25,2,2,0,1.994
2886,14.25,1,1,0,1.997
2887,259,700,438,262,0.424
2888,306.75,723,443,280,0.391
2889,284.25,638,417,221,0.528
2890,7,0,0,0,2
2891,290.5,669,419,250,0.493
2892,334.5,682,439,243,0.44
2893,261.25,657,422,235,0.499
2894,12,0,0,0,2
2895,7.75,0,0,0,2
2896,21.75,1,1,0,1.997
2897,227.5,665,431,234,0.473
2898,7.75,0,0,0,2
2899,22,0,0,0,2
2900,35.5,4,2,2,1.992
2901,292.25,622,415,207,0.548
2902,8.25,0,0,0,2
2903,261.25,609,394,215,0.603
2904,13.25,0,0,0,2
2905,292.5,721,456,265,0.367
2906,6,0,0,0,2
2907,30.5,0,0,0,2
2908,23.75,1,0,1,1.999
2909,269.5,646,413,233,0.528
2910,5.25,0,0,0,2
2911,295.5,724,452,272,0.372
2912,4.25,0,0,0,2
2913,17,0,0,0,2
2914,280.5,682,450,232,0.418
2915,256,685,437,248,0.441
2916,228.75,692,451,241,0.406
2917,244.75,655,438,217,0.469
2918,12.25,0,0,0,2
2919,18.75,0,0,0,2
2920,237.25,675,428,247,0.469
2921,18.75,1,0,1,1.999
2922,238,660,422,238,0.496
2923,283.75,710,445,265,0.4
2924,239.75,681,431,250,0.457
2925,234.75,721,456,265,0.367
2926,42,3,2,1,1.993
2927,248.75,688,427,261,0.458
2928,220,665,425,240,0.485
2929,30.25,0,0,0,2
2930,8.75,0,0,0,2
2931,239.25,719,454,265,0.373
2932,373.25,658,429,229,0.484
2933,203.5,704,453,251,0.39
2934,285.5,715,446,269,0.393
2935,4.75,0,0,0,2
2936,269.25,677,439,238,0.445
2937,366,675,434,241,0.457
2938,253.25,692,451,241,0.406
2939,243.25,702,441,261,0.416
2940,337,638,419,219,0.524
2941,18,0,0,0,2
2942,236.5,660,435,225,0.47
2943,289.75,724,451,273,0.374
2944,20.5,1,1,0,1.997
2945,289.25,673,431,242,0.465
2946,287.75,692,432,260,0.444
2947,221.5,725,452,273,0.371
2948,201.5,660,421,239,0.498
2949,84.75,11,7,4,1.975
2950,15,0,0,0,2
2951,14.25,0,0,0,2
2952,272.75,654,410,244,0.526
2953,10,0,0,0,2
2954,247.25,718,450,268,0.382
2955,218.5,683,436,247,0.445
2956,308.5,675,427,248,0.471
2957,271.5,673,434,239,0.459
2958,36.25,5,5,0,1.985
2959,292.75,656,422,234,0.5
2960,239.25,685,438,247,0.439
2961,252.75,665,434,231,0.467
2962,256.25,681,421,260,0.477
2963,290.25,633,407,226,0.553
2964,244.5,691,429,262,0.451
2965,7.5,0,0,0,2
2966,291.25,698,435,263,0.432
2967,289.75,683,440,243,0.437
2968,4,0,0,0,2
2969,290.25,704,436,268,0.424
2970,238.5,681,432,249,0.455
2971,278.75,630,413,217,0.544
2972,28.5,1,0,1,1.999
2973,20.75,0,0,0,2
2974,245,698,439,259,0.424
2975,16.25,0,0,0,2
2976,227.5,607,401,206,0.591
2977,276.25,660,432,228,0.476
2978,254.75,663,437,226,0.463
2979,233.5,666,435,231,0.464
2980,283.75,704,447,257,0.402
2981,453.5,631,405,226,0.559
2982,214,666,431,235,0.472
2983,17,0,0,0,2
2984,245.75,688,443,245,0.426
2985,13.5,0,0,0,2
2986,275.75,740,452,288,0.356
2987,267.5,663,425,238,0.487
2988,225.75,700,437,263,0.426
2989,248.75,674,431,243,0.464
2990,216.5,656,421,235,0.502
2991,34.25,2,1,1,1.996
2992,260.5,710,437,273,0.416
2993,6.5,0,0,0,2
2994,22,0,0,0,2
2995,281.75,684,427,257,0.462
2996,21.25,0,0,0,2
2997,261.75,681,435,246,0.449
2998,46.75,4,3,1,1.99
2999,252.75,663,420,243,0.497
3000,325,682,446,236,0.426
3001,221.5,700,434,266,0.432
3002,215.75,690,446,244,0.418
3003,237.5,657,428,229,0.487
3004,352.75,675,429,246,0.467
3005,208.5,731,456,275,0.357
3006,16.25,0,0,0,2
3007,218.5,683,436,247,0.445
3008,327.25,703,440,263,0.417
3009,331.5,663,434,229,0.469
3010,231,682,437,245,0.444
3011,287.25,667,431,236,0.471
3012,248.5,675,438,237,0.449
3013,415.5,690,436,254,0.438
3014,246.75,674,423,251,0.48
3015,267.25,676,427,249,0.47
3016,275.25,691,431,260,0.447
3017,15.75,1,1,0,1.997
3018,256.25,719,444,275,0.393
3019,225,641,418,223,0.523
3020,214,681,436,245,0.447
3021,273,714,445,269,0.396
3022,10.5,0,0,0,2
3023,248,666,426,240,0.482
3024,397.25,702,436,266,0.426
3025,32.25,0,0,0,2
3026,275,716,445,271,0.394
3027,5.5,0,0,0,2
3028,281.25,698,438,260,0.426
3029,20.25,0,0,0,2
3030,255.5,684,435,249,0.446
3031,291.5,709,447,262,0.397
3032,291.5,726,454,272,0.366
3033,9.25,0,0,0,2
3034,309.25,729,449,280,0.373
3035,23.25,1,1,0,1.997
3036,11.25,0,0,0,2
3037,23.5,1,1,0,1.997
3038,275,691,437,254,0.435
3039,377.5,669,419,250,0.493
3040,264.75,674,437,237,0.452
3041,379,657,424,233,0.495
3042,267.25,717,443,274,0.397
3043,216,656,429,227,0.486
3044,244.25,695,438,257,0.429
3045,269.25,704,439,265,0.418
3046,10.75,0,0,0,2
3047,16,0,0,0,2
3048,303,684,429,255,0.458
3049,32.25,3,1,2,1.995
3050,280.5,713,454,259,0.379
3051,277.75,678,445,233,0.432
3052,271,660,436,224,0.468
3053,34.5,0,0,0,2
3054,272.5,686,439,247,0.436
3055,270,698,442,256,0.418
3056,248.75,676,426,250,0.472
3057,318.25,675,428,247,0.469
3058,217.5,654,430,224,0.486
3059,4.75,0,0,0,2
3060,52.75,2,1,1,1.996
3061,16,0,0,0,2
3062,284.75,630,410,220,0.55
3063,294.25,654,432,222,0.482
3064,248.25,670,430,240,0.47
3065,295,610,411,199,0.568
3066,251.75,689,431,258,0.449
3067,61.5,5,4,1,1.987
3068,247.25,657,424,233,0.495
3069,5,0,0,0,2
3070,11.5,0,0,0,2
3071,295.25,678,434,244,0.454
3072,16.5,1,1,0,1.997
3073,11.5,0,0,0,2
3074,202.25,691,443,248,0.423
3075,259.5,667,425,242,0.483
3076,3.25,0,0,0,2
3077,250.25,665,430,235,0.475
3078,252.25,700,449,251,0.402
3079,258.75,660,426,234,0.488
3080,236.75,723,465,258,0.347
3081,20.75,0,0,0,2
3082,234.25,669,437,232,0.457
3083,292.5,711,458,253,0.373
3084,271.75,716,449,267,0.386
3085,212,664,435,229,0.466
3086,298,705,444,261,0.407
3087,8.5,0,0,0,2
3088,227.75,684,446,238,0.424
3089,350.75,697,434,263,0.435
3090,232.5,702,435,267,0.428
3091,28.5,1,0,1,1.999
3092,17.75,0,0,0,2
3093,41.5,0,0,0,2
3094,19.75,0,0,0,2
3095,11.75,0,0,0,2
3096,243.5,690,425,265,0.46
3097,228.25,660,430,230,0.48
3098,238.25,662,433,229,0.472
3099,348.25,625,415,210,0.545
3100,292.25,675,429,246,0.467
3101,241.25,709,444,265,0.403
3102,290.5,684,428,256,0.46
3103,21.25,0,0,0,2
3104,200.25,652,422,230,0.504
3105,250.25,695,444,251,0.417
3106,229,729,455,274,0.361
3107,300.75,684,434,250,0.448
3108,280.25,678,432,246,0.458
3109,310.75,706,438,268,0.418
3110,27.5,3,3,0,1.991
3111,8.75,0,0,0,2
3112,265.75,669,433,236,0.465
3113,248.5,669,432,237,0.467
3114,309.75,676,424,252,0.476
3115,246.25,699,444,255,0.413
3116,258.25,681,440,241,0.439
3117,253.25,659,427,232,0.487
3118,262.75,686,444,242,0.426
3119,303,666,432,234,0.47
3120,13,0,0,0,2
3121,214.75,658,423,235,0.496
3122,229.25,687,443,244,0.427
3123,15.75,0,0,0,2
3124,315.25,687,450,237,0.413
3125,287.5,685,443,242,0.429
3126,325.5,670,421,249,0.488
3127,257,698,437,261,0.428
3128,299.25,689,432,257,0.447
3129,29.75,0,0,0,2
3130,11.75,0,0,0,2
3131,269.5,688,447,241,0.418
3132,26.25,0,0,0,2
3133,35.75,0,0,0,2
3134,320.5,663,439,224,0.459
3135,304.5,701,452,249,0.395
3136,24,2,2,0,1.994
3137,302.75,744,461,283,0.334
3138,308.5,654,412,242,0.522
3139,331.25,708,447,261,0.398
3140,288.25,669,442,227,0.447
3141,333.5,658,413,245,0.516
3142,316.75,691,444,247,0.421
3143,17.5,0,0,0,2
3144,257.5,652,416,236,0.516
3145,271.5,669,432,237,0.467
3146,253.75,697,452,245,0.399
3147,323.5,718,449,269,0.384
3148,232.25,662,434,228,0.47
3149,349.75,693,435,258,0.437
3150,289,659,428,231,0.485
3151,235,697,440,257,0.423
3152,231.75,689,432,257,0.447
3153,224.5,635,428,207,0.509
3154,410.75,716,454,262,0.376
3155,292.5,660,429,231,0.482
3156,192.25,689,447,242,0.417
3157,224,695,441,254,0.423
3158,243.5,704,455,249,0.386
3159,190.25,616,394,222,0.596
3160,229.25,686,446,240,0.422
3161,115.75,17,10,7,1.963
3162,14,0,0,0,2
3163,283.75,677,436,241,0.451
3164,10,0,0,0,2
3165,295.25,656,426,230,0.492
3166,39.75,3,2,1,1.993
3167,10,0,0,0,2
3168,239.5,691,425,266,0.459
3169,241.25,673,440,233,0.447
3170,252.25,627,411,216,0.551
3171,228.75,694,438,256,0.43
3172,268,656,438,218,0.468
3173,306.5,688,447,241,0.418
3174,16.75,0,0,0,2
3175,309,697,430,267,0.443
3176,356.25,680,446,234,0.428
3177,17.75,0,0,0,2
3178,282,697,443,254,0.417
3179,318,694,434,260,0.438
3180,19.75,0,0,0,2
3181,243.75,690,439,251,0.432
3182,12.25,0,0,0,2
3183,270.5,652,421,231,0.506
3184,264,666,423,243,0.488
3185,227.5,700,439,261,0.422
3186,260.75,687,431,256,0.451
3187,277.25,671,421,250,0.487
3188,262,676,429,247,0.466
3189,382.25,728,447,281,0.378
3190,9.75,0,0,0,2
3191,430.5,709,448,261,0.395
3192,285.75,690,447,243,0.416
3193,227.25,626,423,203,0.528
3194,18.25,0,0,0,2
3195,14,0,0,0,2
3196,17.75,0,0,0,2
3197,260,644,418,226,0.52
3198,350.25,683,438,245,0.441
3199,236.5,723,454,269,0.369
3200,251.25,687,445,242,0.423
3201,286.75,665,432,233,0.471
3202,225.5,646,423,223,0.508
3203,45.5,2,1,1,1.996
3204,241.25,673,429,244,0.469
3205,237,708,450,258,0.392
3206,316.25,690,446,244,0.418
3207,20.5,0,0,0,2
3208,267.25,683,435,248,0.447
3209,49,2,2,0,1.994
3210,14.25,0,0,0,2
3211,33.5,2,2,0,1.994
3212,18.25,0,0,0,2
3213,271.5,687,430,257,0.453
3214,260.5,638,416,222,0.53
3215,15.75,1,1,0,1.997
3216,257,679,430,249,0.461
3217,252.25,640,415,225,0.53
3218,12.5,0,0,0,2
3219,38,0,0,0,2
3220,307.5,666,428,238,0.478
3221,189,689,443,246,0.425
3222,267.5,643,422,221,0.513
3223,270,734,453,281,0.36
3224,5.75,0,0,0,2
3225,232.25,702,443,259,0.412
3226,225.75,677,423,254,0.477
3227,234.5,668,431,237,0.47
3228,9.75,0,0,0,2
3229,15.25,0,0,0,2
3230,281.5,717,450,267,0.383
3231,247.25,719,446,273,0.389
3232,231,711,456,255,0.377
3233,6.25,0,0,0,2
3234,11.5,0,0,0,2
3235,242.5,642,421,221,0.516
3236,24,2,1,1,1.996
3237,211.5,711,447,264,0.395
3238,276.5,683,434,249,0.449
3239,270.5,669,432,237,0.467
3240,251.75,673,429,244,0.469
3241,234,691,431,260,0.447
3242,309.5,635,410,225,0.545
3243,252.25,679,431,248,0.459
3244,11.75,0,0,0,2
3245,244.75,692,442,250,0.424
3246,20.25,1,1,0,1.997
3247,203.25,709,443,266,0.405
3248,251.75,690,438,252,0.434
3249,8.25,0,0,0,2
3250,343,638,423,215,0.516
3251,236.75,738,453,285,0.356
3252,252.5,723,447,276,0.383
3253,23.5,0,0,0,2
3254,356,685,444,241,0.427
3255,266,655,418,237,0.509
3256,313,664,419,245,0.498
3257,321,715,444,271,0.397
3258,30.25,2,1,1,1.996
3259,18,0,0,0,2
3260,228.5,712,448,264,0.392
3261,196.75,698,440,258,0.422
3262,9.5,0,0,0,2
3263,22,0,0,0,2
3264,258.75,713,453,260,0.381
3265,245.25,611,411,200,0.567
3266,293.75,682,429,253,0.46
3267,18.5,0,0,0,2
3268,304.5,700,444,256,0.412
3269,269.25,676,437,239,0.45
3270,12.75,0,0,0,2
3271,308.25,684,428,256,0.46
3272,36,1,1,0,1.997
3273,32.75,2,0,2,1.998
3274,301.25,688,435,253,0.442
3275,301,678,431,247,0.46
3276,273,684,443,241,0.43
3277,298.75,759,460,299,0.321
3278,8.25,0,0,0,2
3279,291,684,425,259,0.466
3280,287.25,718,439,279,0.404
3281,270,627,405,222,0.563
3282,295,711,437,274,0.415
3283,314,719,445,274,0.391
3284,15.25,0,0,0,2
3285,41.75,2,0,2,1.998
3286,405.5,701,446,255,0.407
3287,48.75,3,3,0,1.991
3288,270,680,434,246,0.452
3289,263,597,405,192,0.593
3290,254.5,659,433,226,0.475
3291,327,645,422,223,0.511
3292,345.5,660,417,243,0.506
3293,237.75,641,420,221,0.519
3294,12,0,0,0,2
3295,10.25,0,0,0,2
3296,211,657,425,232,0.493
3297,283.25,670,422,248,0.486
3298,277,658,434,224,0.474
3299,305.5,635,413,222,0.539
3300,221.25,727,449,278,0.375
3301,259.75,696,442,254,0.42
3302,295,699,453,246,0.395
3303,359.5,679,440,239,0.441
3304,225.25,724,454,270,0.368
3305,264.75,680,440,240,0.44
3306,358.5,676,421,255,0.482
3307,254.75,647,428,219,0.497
3308,242.5,709,449,260,0.393
3309,63.5,4,3,1,1.99
3310,256.75,714,447,267,0.392
3311,240.5,689,440,249,0.431
3312,6.25,0,0,0,2
3313,15.5,0,0,0,2
3314,274,667,426,241,0.481
3315,251.75,661,431,230,0.477
3316,341.25,718,447,271,0.388
3317,202.25,689,440,249,0.431
3318,14,0,0,0,2
3319,44.5,3,2,1,1.993
3320,269.25,709,450,259,0.391
3321,236.75,717,445,272,0.393
3322,307,732,443,289,0.382
3323,8.5,0,0,0,2
3324,239.25,707,437,270,0.419
3325,274.5,712,437,275,0.414
3326,202.5,691,436,255,0.437
3327,239.25,651,421,230,0.507
3328,289.75,652,428,224,0.492
3329,25.75,1,0,1,1.999
3330,204.25,725,440,285,0.395
3331,53.75,3,2,1,1.993
3332,253.5,710,446,264,0.398
3333,24.5,0,0,0,2
3334,315.75,701,449,252,0.401
3335,261,702,440,262,0.418
3336,235.25,709,444,265,0.403
3337,237.5,648,427,221,0.498
3338,33.25,0,0,0,2
3339,273,669,428,241,0.475
3340,255.5,701,443,258,0.413
3341,201.75,735,460,275,0.345
3342,272.5,714,456,258,0.374
3343,55.75,6,6,0,1.982
3344,40.25,3,3,0,1.991
3345,317.25,715,445,270,0.395
3346,254.5,694,449,245,0.408
3347,9.5,0,0,0,2
3348,273,701,448,253,0.403
3349,6.25,0,0,0,2
3350,347.25,670,431,239,0.468
3351,45,3,2,1,1.993
3352,271,736,457,279,0.35
3353,7,0,0,0,2
3354,25,1,1,0,1.997
3355,279,696,439,257,0.426
3356,300.5,748,454,294,0.344
3357,249.5,703,447,256,0.403
3358,9.75,0,0,0,2
3359,293.75,653,421,232,0.505
3360,261.25,714,443,271,0.4
3361,24.75,0,0,0,2
3362,18.75,0,0,0,2
3363,12,0,0,0,2
3364,12,0,0,0,2
3365,289.5,695,428,267,0.449
3366,245.25,667,438,229,0.457
3367,12,0,0,0,2
3368,249.5,680,426,254,0.468
3369,326.25,672,421,251,0.486
3370,254,632,420,212,0.528
3371,253.75,664,429,235,0.478
3372,246.5,720,443,277,0.394
3373,276,703,454,249,0.389
3374,21.75,0,0,0,2
3375,284.25,665,421,244,0.493
3376,277.25,639,420,219,0.521
3377,259,649,425,224,0.501
3378,15,0,0,0,2
3379,202.25,710,449,261,0.392
3380,263.75,617,404,213,0.575
3381,346,671,431,240,0.467
3382,235.75,704,444,260,0.408
3383,39.75,3,2,1,1.993
3384,11,0,0,0,2
3385,41.25,1,0,1,1.999
3386,230.5,692,428,264,0.452
3387,307.5,677,432,245,0.459
3388,11.5,0,0,0,2
3389,276.25,671,435,236,0.459
3390,313.5,699,441,258,0.419
3391,267.5,660,429,231,0.482
3392,241.75,696,436,260,0.432
3393,288.25,621,412,209,0.555
3394,297.5,664,423,241,0.49
3395,13.75,0,0,0,2
3396,12.5,0,0,0,2
3397,261.5,684,436,248,0.444
3398,219.25,658,428,230,0.486
3399,9.75,0,0,0,2
3400,29,0,0,0,2
3401,312,655,414,241,0.517
3402,226.25,720,445,275,0.39
3403,287.25,698,450,248,0.402
3404,221.75,688,438,250,0.436
3405,17.25,1,1,0,1.997
3406,7.25,0,0,0,2
3407,85.75,6,5,1,1.984
3408,26,1,1,0,1.997
3409,7.5,0,0,0,2
3410,14.5,0,0,0,2
3411,241.75,673,430,243,0.467
3412,279.5,623,410,213,0.557
3413,247,670,441,229,0.448
3414,262.75,657,415,242,0.513
3415,291.25,713,447,266,0.393
3416,288,721,452,269,0.375
3417,309.5,666,433,233,0.468
3418,424.25,673,436,237,0.455
3419,55.75,2,0,2,1.998
3420,224.75,687,447,240,0.419
3421,9.75,0,0,0,2
3422,245.75,636,419,217,0.526
3423,257,679,445,234,0.431
3424,294.75,662,427,235,0.484
3425,27.25,0,0,0,2
3426,331.25,670,440,230,0.45
3427,272.5,685,432,253,0.451
3428,291.25,715,452,263,0.381
3429,17.25,0,0,0,2
3430,4.5,0,0,0,2
3431,288,648,424,224,0.504
3432,22.75,0,0,0,2
3433,272.5,677,429,248,0.465
3434,274,709,451,258,0.389
3435,313,675,427,248,0.471
3436,408.25,663,427,236,0.483
3437,250.5,666,418,248,0.498
3438,313.5,653,421,232,0.505
3439,218.75,725,445,280,0.385
3440,337.5,683,437,246,0.443
3441,211.5,705,451,254,0.393
3442,244.5,645,412,233,0.531
3443,234,711,449,262,0.391
3444,195.25,659,424,235,0.493
3445,23.5,1,1,0,1.997
3446,253,673,439,234,0.449
3447,283.75,726,449,277,0.376
3448,253.5,721,445,276,0.389
3449,298.25,688,438,250,0.436
3450,262.5,697,435,262,0.433
3451,286,669,428,241,0.475
3452,296.25,659,437,222,0.467
3453,244,714,446,268,0.394
3454,14,1,0,1,1.999
3455,21,1,1,0,1.997
3456,228.25,679,430,249,0.461
3457,313.25,689,438,251,0.435
3458,295.5,693,432,261,0.443
3459,319.25,677,440,237,0.443
3460,292.5,686,432,254,0.45
3461,206,702,451,251,0.396
3462,301,671,429,242,0.471
3463,263.5,677,439,238,0.445
3464,10.75,0,0,0,2
3465,13.5,0,0,0,2
3466,32,1,1,0,1.997
3467,248.75,668,426,242,0.48
3468,239.75,657,422,235,0.499
3469,29,1,1,0,1.997
3470,323.5,699,439,260,0.423
3471,61.75,2,0,2,1.998
3472,258.75,671,424,247,0.481
3473,285.5,689,440,249,0.431
3474,46.75,7,5,2,1.983
3475,19,0,0,0,2
3476,254,720,453,267,0.374
3477,20.25,0,0,0,2
3478,75.75,8,6,2,1.98
3479,11.5,0,0,0,2
3480,291.5,750,466,284,0.318
3481,8.75,0,0,0,2
3482,235.5,734,459,275,0.348
3483,246.25,732,464,268,0.34
3484,250.25,657,428,229,0.487
3485,8.5,0,0,0,2
3486,273.75,648,430,218,0.492
3487,278.5,667,437,230,0.459
3488,264.25,710,444,266,0.402
3489,231.5,728,452,276,0.368
3490,362,647,434,213,0.485
3491,10.5,0,0,0,2
3492,256.25,710,445,265,0.4
3493,49,2,2,0,1.994
3494,355.25,659,435,224,0.471
3495,245,662,426,236,0.486
3496,7,0,0,0,2
3497,237.75,710,454,256,0.382
3498,14,0,0,0,2
3499,23.25,0,0,0,2
3500,231.5,722,461,261,0.356
3501,6,0,0,0,2
3502,234,687,442,245,0.429
3503,255.25,658,425,233,0.492
3504,260,692,441,251,0.426
3505,307.5,683,433,250,0.451
3506,261.5,710,441,269,0.408
3507,228.25,684,441,243,0.434
3508,290.5,716,445,271,0.394
3509,25.75,0,0,0,2
3510,269.5,701,448,253,0.403
3511,14.5,0,0,0,2
3512,266,662,426,236,0.486
3513,227.5,660,429,231,0.482
3514,247.25,688,436,252,0.44
3515,9.25,0,0,0,2
3516,206.75,679,436,243,0.449
3517,291,654,419,235,0.508
3518,239.5,737,461,276,0.341
3519,237,741,461,280,0.337
3520,27,0,0,0,2
3521,4.75,0,0,0,2
3522,250.75,697,430,267,0.443
3523,271,651,430,221,0.489
3524,62,3,2,1,1.993
3525,231,688,441,247,0.43
3526,269.25,678,423,255,0.476
3527,248.75,723,448,275,0.381
3528,23,0,0,0,2
3529,265,702,445,257,0.408
3530,42.75,8,5,3,1.982
3531,250.75,710,438,272,0.414
3532,249,668,431,237,0.47
3533,232,663,434,229,0.469
3534,51.25,0,0,0,2
3535,221.5,665,425,240,0.485
3536,241.75,703,447,256,0.403
3537,344.75,703,449,254,0.399
3538,321.25,687,443,244,0.427
3539,317.25,701,441,260,0.417
3540,339,637,417,220,0.529
3541,268,717,441,276,0.401
3542,13.5,0,0,0,2
3543,14.5,1,1,0,1.997
3544,308.75,706,444,262,0.406
3545,293,666,426,240,0.482
3546,265,688,431,257,0.45
3547,264,642,417,225,0.524
3548,19.5,2,1,1,1.996
3549,225.25,707,451,256,0.391
3550,18,1,1,0,1.997
3551,17.75,1,1,0,1.997
3552,10,0,0,0,2
3553,298.25,680,439,241,0.442
3554,287.75,643,429,214,0.499
3555,256.25,691,435,256,0.439
3556,264.25,719,447,272,0.387
3557,40.75,2,2,0,1.994
3558,9.5,0,0,0,2
3559,281.75,650,417,233,0.516
3560,241.75,682,439,243,0.44
3561,27.5,1,0,1,1.999
3562,292.5,678,444,234,0.434
3563,8,0,0,0,2
3564,279.5,703,438,265,0.421
3565,6.75,0,0,0,2
3566,327.75,677,431,246,0.461
3567,210.75,733,447,286,0.373
3568,9.75,0,0,0,2
3569,11.25,0,0,0,2
3570,312.25,680,433,247,0.454
3571,234.5,712,443,269,0.402
3572,5.25,0,0,0,2
3573,11,1,1,0,1.997
3574,224.25,708,443,265,0.406
3575,240.25,645,419,226,0.517
3576,229.25,710,442,268,0.406
3577,239,678,421,257,0.48
3578,18,0,0,0,2
3579,324,710,435,275,0.42
3580,243,711,443,268,0.403
3581,238.75,680,438,242,0.444
3582,269.75,708,442,266,0.408
3583,47.75,4,3,1,1.99
3584,260.75,692,450,242,0.408
3585,10.75,0,0,0,2
3586,269.5,694,436,258,0.434
3587,16.75,0,0,0,2
3588,237.25,652,426,226,0.496
3589,384.25,658,417,241,0.508
3590,239.25,700,439,261,0.422
3591,52.25,6,5,1,1.984
3592,316,657,431,226,0.481
3593,17,2,0,2,1.998
3594,17.5,0,0,0,2
3595,21.5,0,0,0,2
3596,35.25,1,1,0,1.997
3597,357.75,658,432,226,0.478
3598,328.25,670,432,238,0.466
3599,226.75,691,438,253,0.433
3600,282.75,699,440,259,0.421
3601,288,652,438,214,0.472
3602,52.75,3,3,0,1.991
3603,11.25,0,0,0,2
3604,247.5,675,432,243,0.461
3605,234.75,698,448,250,0.406
3606,239.5,653,441,212,0.465
3607,8.5,0,0,0,2
3608,15.5,0,0,0,2
3609,243,716,438,278,0.408
3610,327.5,684,437,247,0.442
3611,271.5,684,434,250,0.448
3612,23.25,0,0,0,2
3613,37.5,1,1,0,1.997
3614,267.75,681,433,248,0.453
3615,285.5,724,447,277,0.382
3616,310,694,432,262,0.442
3617,220,685,435,250,0.445
3618,244.25,655,414,241,0.517
3619,5.25,0,0,0,2
3620,59,5,5,0,1.985
3621,275.75,675,437,238,0.451
3622,263.5,712,446,266,0.396
3623,278,723,446,277,0.385
3624,4.5,0,0,0,2
3625,261.5,718,449,269,0.384
3626,246.5,687,434,253,0.445
3627,212.25,696,434,262,0.436
3628,310.75,713,441,272,0.405
3629,235,703,436,267,0.425
3630,257.25,694,446,248,0.414
3631,18.5,0,0,0,2
3632,67,6,5,1,1.984
3633,15.5,0,0,0,2
3634,246.25,701,443,258,0.413
3635,256.25,661,433,228,0.473
3636,236.75,712,452,260,0.384
3637,40.25,1,1,0,1.997
3638,252.75,650,415,235,0.52
3639,6.5,0,0,0,2
3640,234.25,686,445,241,0.424
3641,259.5,700,446,254,0.408
3642,308.75,654,426,228,0.494
3643,271.5,694,438,256,0.43
3644,255.25,711,443,268,0.403
3645,42.5,3,3,0,1.991
3646,185.25,713,438,275,0.411
3647,50.75,1,1,0,1.997
3648,267.75,661,435,226,0.469
3649,15,0,0,0,2
3650,204,668,429,239,0.474
3651,29.75,0,0,0,2
3652,222.5,693,437,256,0.433
3653,233.5,650,417,233,0.516
3654,14,0,0,0,2
3655,8.75,0,0,0,2
3656,233.25,655,433,222,0.479
3657,288.25,657,439,218,0.465
3658,29.5,0,0,0,2
3659,271.25,674,417,257,0.492
3660,268.5,726,442,284,0.39
3661,228,688,434,254,0.444
3662,16.75,0,0,0,2
3663,307.75,659,432,227,0.477
3664,22.5,0,0,0,2
3665,19.5,0,0,0,2
3666,275.5,724,454,270,0.368
3667,222.25,714,445,269,0.396
3668,276,698,432,266,0.438
3669,6.75,0,0,0,2
3670,322.75,640,416,224,0.528
3671,246.5,688,453,235,0.406
3672,238.25,726,455,271,0.364
3673,21.25,0,0,0,2
3674,228.75,681,433,248,0.453
3675,19.5,0,0,0,2
3676,346,703,437,266,0.423
3677,242,679,445,234,0.431
3678,260.25,662,422,240,0.494
3679,11.75,0,0,0,2
3680,263.25,659,425,234,0.491
3681,325.5,680,430,250,0.46
3682,317,655,418,237,0.509
3683,305,672,431,241,0.466
3684,13.75,0,0,0,2
3685,33.5,1,1,0,1.997
3686,8.75,0,0,0,2
3687,337.75,716,450,266,0.384
3688,262.25,697,445,252,0.413
3689,251,689,430,259,0.451
3690,287,646,436,210,0.482
3691,38.25,0,0,0,2
3692,10.5,0,0,0,2
3693,367.75,680,442,238,0.436
3694,328,652,424,228,0.5
3695,278.25,693,435,258,0.437
3696,272.25,735,462,273,0.341
3697,14,0,0,0,2
3698,217,680,443,237,0.434
3699,23.25,0,0,0,2
3700,244.75,669,431,238,0.469
3701,11.5,0,0,0,2
3702,333.25,639,413,226,0.535
3703,32.75,0,0,0,2
3704,245.25,696,428,268,0.448
3705,289,671,428,243,0.473
3706,10,0,0,0,2
3707,254,708,448,260,0.396
3708,232.5,717,451,266,0.381
3709,274.5,666,430,236,0.474
3710,42.25,5,3,2,1.989
3711,305,673,425,248,0.477
3712,284,658,414,244,0.514
3713,17.5,0,0,0,2
3714,266.75,658,438,220,0.466
3715,6.75,0,0,0,2
3716,266,664,436,228,0.464
3717,266.75,681,439,242,0.441
3718,19.5,0,0,0,2
3719,22,0,0,0,2
3720,318.5,679,434,245,0.453
3721,237.25,688,439,249,0.434
3722,277,664,425,239,0.486
3723,47.25,4,3,1,1.99
3724,35,6,4,2,1.986
3725,225.75,720,453,267,0.374
3726,217.25,687,438,249,0.437
3727,207,676,431,245,0.462
3728,6.5,0,0,0,2
3729,235.5,726,447,279,0.38
3730,297.75,690,441,249,0.428
3731,242.5,718,444,274,0.394
3732,23.75,1,0,1,1.999
3733,295,671,440,231,0.449
3734,215.75,649,411,238,0.529
3735,58.75,2,2,0,1.994
3736,227.25,707,437,270,0.419
3737,208,711,443,268,0.403
3738,231.75,661,417,244,0.505
3739,235.75,720,459,261,0.362
3740,218.5,688,432,256,0.448
3741,247.5,661,430,231,0.479
3742,271.75,685,438,247,0.439
3743,273,680,437,243,0.446
3744,290.25,675,422,253,0.481
3745,35.5,4,3,1,1.99
3746,212.75,665,423,242,0.489
3747,9.5,0,0,0,2
3748,239,684,434,250,0.448
3749,231.75,717,439,278,0.405
3750,48.5,2,1,1,1.996
3751,282,680,439,241,0.442
3752,253.75,639,417,222,0.527
3753,235,688,441,247,0.43
3754,14.25,0,0,0,2
3755,265,699,435,264,0.431
3756,11.75,0,0,0,2
3757,11.75,0,0,0,2
3758,282,696,432,264,0.44
3759,27.75,0,0,0,2
3760,13.75,0,0,0,2
3761,223.5,703,444,259,0.409
3762,246.25,677,438,239,0.447
3763,233.25,676,441,235,0.442
3764,345,678,429,249,0.464
3765,271.5,721,454,267,0.371
3766,281,643,422,221,0.513
3767,286.5,672,429,243,0.47
3768,22.75,1,1,0,1.997
3769,9.25,0,0,0,2
3770,269.5,607,400,207,0.593
3771,7.75,0,0,0,2
3772,242.25,658,422,236,0.498
3773,28,0,0,0,2
3774,258.25,691,438,253,0.433
3775,233,724,455,269,0.366
3776,421.5,637,411,226,0.541
3777,233.5,689,430,259,0.451
3778,277.75,649,434,215,0.483
3779,28.75,1,1,0,1.997
3780,17.75,1,1,0,1.997
3781,14,0,0,0,2
3782,263.75,642,434,208,0.49
3783,279.5,693,438,255,0.431
3784,224.25,716,452,264,0.38
3785,268.5,708,440,268,0.412
3786,258.25,667,439,228,0.455
3787,239.25,670,427,243,0.476
3788,281.25,642,413,229,0.532
3789,367.75,675,424,251,0.477
3790,266.5,692,432,260,0.444
3791,235.75,696,448,248,0.408
3792,193.5,683,438,245,0.441
3793,255.75,626,411,215,0.552
3794,256.75,680,424,256,0.472
3795,217.25,647,420,227,0.513
3796,270.75,663,420,243,0.497
3797,22.75,0,0,0,2
3798,259.5,663,428,235,0.481
3799,22.25,0,0,0,2
3800,443.5,654,416,238,0.514
3801,26.75,2,1,1,1.996
3802,219,661,427,234,0.485
3803,272.25,699,452,247,0.397
3804,280.25,708,452,256,0.388
3805,409.25,622,415,207,0.548
3806,315.25,716,453,263,0.378
3807,9.75,0,0,0,2
3808,283.5,654,419,235,0.508
3809,352.5,673,449,224,0.429
3810,234.5,651,429,222,0.491
3811,290.5,681,434,247,0.451
3812,244.75,648,416,232,0.52
3813,210.25,690,442,248,0.426
3814,284.5,690,448,242,0.414
3815,247.5,675,428,247,0.469
3816,234.5,717,451,266,0.381
3817,311,660,415,245,0.51
3818,14.25,1,1,0,1.997
3819,236,722,450,272,0.378
3820,330.25,704,441,263,0.414
3821,279.25,649,425,224,0.501
3822,15.25,0,0,0,2
3823,11,0,0,0,2
3824,223.75,687,439,248,0.435
3825,264,677,438,239,0.447
3826,16,0,0,0,2
3827,247,690,433,257,0.444
3828,262.75,719,452,267,0.377
3829,16.25,0,0,0,2
3830,27.75,0,0,0,2
3831,250.75,672,430,242,0.468
3832,340.5,696,450,246,0.404
3833,6.75,0,0,0,2
3834,244,723,451,272,0.375
3835,257,685,433,252,0.449
3836,236.75,705,451,254,0.393
3837,207,655,431,224,0.483
3838,11.25,0,0,0,2
3839,337.75,678,424,254,0.474
3840,227.75,633,423,210,0.521
3841,20.75,0,0,0,2
3842,336.75,705,433,272,0.429
3843,281.75,683,433,250,0.451
3844,271,681,422,259,0.475
3845,281,690,430,260,0.45
3846,237.75,715,451,264,0.383
3847,240,676,434,242,0.456
3848,291.25,668,428,240,0.476
3849,318.5,668,418,250,0.496
3850,273.25,712,452,260,0.384
3851,215.5,678,437,241,0.448
3852,251.5,654,429,225,0.488
3853,12.75,0,0,0,2
3854,251,669,427,242,0.477
3855,268.75,647,416,231,0.521
3856,10.5,0,0,0,2
3857,7,0,0,0,2
3858,8.25,0,0,0,2
3859,21.25,1,1,0,1.997
3860,228,695,430,265,0.445
3861,310,692,436,256,0.436
3862,299.5,695,439,256,0.427
3863,11.5,0,0,0,2
3864,281.5,671,430,241,0.469
3865,252.75,677,436,241,0.451
3866,53.25,1,1,0,1.997
3867,23,1,1,0,1.997
3868,244.75,695,442,253,0.421
3869,324,696,449,247,0.406
3870,271.5,691,455,236,0.399
3871,10.5,0,0,0,2
3872,215,647,414,233,0.525
3873,6,0,0,0,2
3874,241.5,712,438,274,0.412
3875,235.25,635,415,220,0.535
3876,306.5,655,423,232,0.499
3877,220,716,449,267,0.386
3878,259.5,709,445,264,0.401
3879,264.75,690,451,239,0.408
3880,288.75,700,445,255,0.41
3881,303,732,454,278,0.36
3882,395.75,659,419,240,0.503
3883,322.25,682,438,244,0.442
3884,258.25,691,442,249,0.425
3885,261.25,687,430,257,0.453
3886,252.5,665,426,239,0.483
3887,242.5,707,449,258,0.395
3888,9.25,0,0,0,2
3889,231,699,444,255,0.413
3890,22,0,0,0,2
3891,335.5,694,442,252,0.422
3892,41,4,4,0,1.988
3893,222.75,707,452,255,0.389
3894,246.25,706,452,254,0.39
3895,349,661,428,233,0.483
3896,13,1,1,0,1.997
3897,266.25,674,425,249,0.476
3898,234.75,671,422,249,0.485
3899,261.5,703,436,267,0.425
3900,26,1,1,0,1.997
3901,266.25,711,450,261,0.389
3902,33.5,1,1,0,1.997
3903,27.5,1,1,0,1.997
3904,277.5,643,418,225,0.521
3905,298.25,613,411,202,0.565
3906,43.25,1,1,0,1.997
3907,33,3,3,0,1.991
3908,20.75,0,0,0,2
3909,270.75,669,429,240,0.473
3910,16.75,0,0,0,2
3911,26.75,1,1,0,1.997
3912,190.5,700,456,244,0.388
3913,231.5,652,423,229,0.502
3914,6.75,0,0,0,2
3915,280,658,421,237,0.5
3916,229.5,672,429,243,0.47
3917,280,647,421,226,0.511
3918,262.75,655,418,237,0.509
3919,245.25,673,449,224,0.429
3920,18,0,0,0,2
3921,257.5,675,435,240,0.455
3922,270.5,693,442,251,0.423
3923,220,748,463,285,0.326
3924,306.5,688,435,253,0.442
3925,20.75,1,1,0,1.997
3926,21.25,1,0,1,1.999
3927,22.75,2,1,1,1.996
3928,293.5,639,416,223,0.529
3929,255.25,711,446,265,0.397
3930,246.75,679,439,240,0.443
3931,248,679,438,241,0.445
3932,244,688,439,249,0.434
3933,9.5,0,0,0,2
3934,54.75,3,1,2,1.995
3935,278.75,702,447,255,0.404
3936,14.25,1,0,1,1.999
3937,263.25,630,416,214,0.538
3938,215.5,686,445,241,0.424
3939,311.25,657,435,222,0.473
3940,230.75,672,444,228,0.44
3941,240.75,719,447,272,0.387
3942,262.75,676,433,243,0.458
3943,49,3,2,1,1.993
3944,26.5,0,0,0,2
3945,277,664,430,234,0.476
3946,41,1,0,1,1.999
3947,230,696,444,252,0.416
3948,212.25,658,422,236,0.498
3949,10.25,0,0,0,2
3950,221.5,648,428,220,0.496
3951,290.25,709,442,267,0.407
3952,21.5,0,0,0,2
3953,17.25,0,0,0,2
3954,218.5,652,425,227,0.498
3955,197.75,706,449,257,0.396
3956,278,725,454,271,0.367
3957,37,2,2,0,1.994
3958,269,679,441,238,0.439
3959,8.25,0,0,0,2
3960,271,665,426,239,0.483
3961,349.5,717,450,267,0.383
3962,24,0,0,0,2
3963,26.75,1,1,0,1.997
3964,15.75,0,0,0,2
3965,15.25,0,0,0,2
3966,244,672,439,233,0.45
3967,281,648,417,231,0.518
3968,313.5,652,425,227,0.498
3969,10.75,0,0,0,2
3970,235.25,670,427,243,0.476
3971,274.25,692,437,255,0.434
3972,20.25,0,0,0,2
3973,248.75,733,466,267,0.335
3974,246.5,680,424,256,0.472
3975,21.5,0,0,0,2
3976,269.5,692,445,247,0.418
3977,277.25,676,431,245,0.462
3978,233.5,733,459,274,0.349
3979,19.75,0,0,0,2
3980,225.75,712,438,274,0.412
3981,240.5,696,442,254,0.42
3982,246.25,648,433,215,0.486
3983,284.25,691,447,244,0.415
3984,260.25,725,458,267,0.359
3985,20.5,0,0,0,2
3986,23.25,1,1,0,1.997
3987,260.25,665,433,232,0.469
3988,320.25,675,435,240,0.455
3989,229.75,720,459,261,0.362
3990,290.5,715,450,265,0.385
3991,25,0,0,0,2
3992,33.75,0,0,0,2
3993,304.5,687,437,250,0.439
3994,286.5,705,440,265,0.415
3995,224.5,689,440,249,0.431
3996,218.5,677,438,239,0.447
3997,78.5,9,8,1,1.975
3998,9.5,0,0,0,2
3999,252.75,714,442,272,0.402
4000,333.25,699,451,248,0.399
4001,224.75,700,442,258,0.416
4002,204.5,718,453,265,0.376
4003,247.5,640,424,216,0.512
4004,283.75,684,441,243,0.434
4005,290.75,683,422,261,0.473
4006,251.5,735,450,285,0.365
4007,294.25,665,430,235,0.475
4008,306.5,704,434,270,0.428
4009,245,712,433,279,0.422
4010,276.5,691,426,265,0.457
4011,220.5,696,446,250,0.412
4012,274.75,645,429,216,0.497
4013,247.25,700,445,255,0.41
4014,16,0,0,0,2
4015,13.5,0,0,0,2
4016,279.5,700,452,248,0.396
4017,269.5,664,431,233,0.474
4018,24,1,1,0,1.997
4019,260.75,684,441,243,0.434
4020,244.5,735,442,293,0.381
4021,14.5,0,0,0,2
4022,235.5,653,424,229,0.499
4023,205.75,622,410,212,0.558
4024,267,708,447,261,0.398
4025,12,0,0,0,2
4026,234.5,733,448,285,0.371
4027,229,704,436,268,0.424
4028,266,701,450,251,0.399
4029,32.75,0,0,0,2
4030,270.5,708,444,264,0.404
4031,245.5,655,419,236,0.507
4032,257.25,696,439,257,0.426
4033,307.25,627,397,230,0.579
4034,12,0,0,0,2
4035,284.25,699,452,247,0.397
4036,223.5,643,412,231,0.533
4037,319.5,699,450,249,0.401
4038,259,719,453,266,0.375
4039,221.25,728,461,267,0.35
4040,13.25,0,0,0,2
4041,26.25,0,0,0,2
4042,316.75,699,452,247,0.397
4043,267,696,443,253,0.418
4044,252.5,684,444,240,0.428
4045,291,712,432,280,0.424
4046,355.75,669,432,237,0.467
4047,211.5,669,418,251,0.495
4048,13.5,0,0,0,2
4049,13.25,0,0,0,2
4050,232.75,688,434,254,0.444
4051,267.25,664,428,236,0.48
4052,230,658,421,237,0.5
4053,268.25,666,440,226,0.454
4054,269.5,678,442,236,0.438
4055,277.5,733,463,270,0.341
4056,7,0,0,0,2
4057,27.75,5,4,1,1.987
4058,16.5,0,0,0,2
4059,17,0,0,0,2
4060,258,703,441,262,0.415
4061,264.75,696,440,256,0.424
4062,254.25,666,434,232,0.466
4063,264.5,674,426,248,0.474
4064,25,1,0,1,1.999
4065,213.25,729,440,289,0.391
4066,253.5,680,439,241,0.442
4067,23.75,2,1,1,1.996
4068,22.25,0,0,0,2
4069,23,1,0,1,1.999
4070,259.75,655,429,226,0.487
4071,236,715,451,264,0.383
4072,353,694,438,256,0.43
4073,251.25,659,430,229,0.481
4074,329,671,438,233,0.453
4075,271,670,432,238,0.466
4076,249.5,690,435,255,0.44
4077,21.25,0,0,0,2
4078,243.75,669,430,239,0.471
4079,300.5,629,405,224,0.561
4080,302.5,659,431,228,0.479
4081,277.25,664,423,241,0.49
4082,280,683,443,240,0.431
4083,19,1,1,0,1.997
4084,7,0,0,0,2
4085,225,693,437,256,0.433
4086,38.75,2,2,0,1.994
4087,249,678,417,261,0.488
4088,296,713,446,267,0.395
4089,6.5,0,0,0,2
4090,230.25,629,412,217,0.547
4091,11.25,0,0,0,2
4092,262,698,443,255,0.416
4093,257.5,671,434,237,0.461
4094,202.25,680,444,236,0.432
4095,218,712,452,260,0.384
4096,18.25,0,0,0,2
4097,299.5,667,428,239,0.477
4098,244.25,681,432,249,0.455
4099,21.5,1,1,0,1.997
4100,243.75,694,441,253,0.424
4101,223.5,705,440,265,0.415
4102,294,703,441,262,0.415
4103,249.5,691,429,262,0.451
4104,257.5,640,419,221,0.522
4105,26.75,0,0,0,2
4106,261.75,677,425,252,0.473
4107,248.5,683,436,247,0.445
4108,213.25,690,440,250,0.43
4109,224.5,717,456,261,0.371
4110,221,721,445,276,0.389
4111,307.25,699,441,258,0.419
4112,280.25,665,425,240,0.485
4113,23,0,0,0,2
4114,316.5,706,445,261,0.404
4115,257.25,669,435,234,0.461
4116,366.25,704,452,252,0.392
4117,208.25,690,450,240,0.41
4118,18.25,0,0,0,2
4119,369,709,448,261,0.395
4120,229.75,714,446,268,0.394
4121,232,660,433,227,0.474
4122,255.25,684,438,246,0.44
4123,15.75,0,0,0,2
4124,15.25,0,0,0,2
4125,32.5,2,1,1,1.996
4126,231.5,647,417,230,0.519
4127,261.75,664,432,232,0.472
4128,219.75,709,451,258,0.389
4129,282.25,688,443,245,0.426
4130,244,694,447,247,0.412
4131,16,0,0,0,2
4132,18.75,0,0,0,2
4133,233.5,679,440,239,0.441
4134,24.25,1,0,1,1.999
4135,223.25,700,446,254,0.408
4136,318.25,660,426,234,0.488
4137,341.75,645,421,224,0.513
4138,11.5,0,0,0,2
4139,327.25,693,447,246,0.413
4140,239.75,673,426,247,0.475
4141,206.75,693,443,250,0.421
4142,245.25,701,447,254,0.405
4143,29.5,1,0,1,1.999
4144,314.25,659,430,229,0.481
4145,364.75,678,431,247,0.46
4146,13.25,0,0,0,2
4147,9.5,0,0,0,2
4148,330.25,641,426,215,0.507
4149,281.25,721,454,267,0.371
4150,231.25,724,451,273,0.374
4151,10.25,0,0,0,2
4152,283.5,671,433,238,0.463
4153,29.25,2,2,0,1.994
4154,238,702,445,257,0.408
4155,277.25,731,453,278,0.363
4156,257,673,432,241,0.463
4157,275.25,649,416,233,0.519
4158,30.75,0,0,0,2
4159,65.75,8,7,1,1.978
4160,35.5,1,0,1,1.999
4161,247.5,662,435,227,0.468
4162,99.5,8,8,0,1.976
4163,15.5,0,0,0,2
4164,19.5,0,0,0,2
4165,259.75,639,422,217,0.517
4166,302.25,634,404,230,0.558
4167,262.5,692,442,250,0.424
4168,27,2,2,0,1.994
4169,319.5,683,444,239,0.429
4170,251.5,708,451,257,0.39
4171,240.25,691,438,253,0.433
4172,16,0,0,0,2
4173,273,681,424,257,0.471
4174,317.75,669,424,245,0.483
4175,26.5,2,2,0,1.994
4176,286,682,434,248,0.45
4177,268.75,657,426,231,0.491
4178,283.5,695,435,260,0.435
4179,27.25,1,1,0,1.997
4180,236.75,679,438,241,0.445
4181,298.5,656,428,228,0.488
4182,19.25,0,0,0,2
4183,234.5,698,441,257,0.42
4184,272.75,678,428,250,0.466
4185,235,690,442,248,0.426
4186,312.75,704,442,262,0.412
4187,258.5,699,442,257,0.417
4188,257.75,660,425,235,0.49
4189,351.25,689,431,258,0.449
4190,241.5,660,424,236,0.492
4191,274.75,656,420,236,0.504
4192,229.25,716,460,256,0.364
4193,265.5,704,443,261,0.41
4194,235.75,646,417,229,0.52
4195,291.25,699,437,262,0.427
4196,42.25,2,2,0,1.994
4197,285.25,682,434,248,0.45
4198,26.25,0,0,0,2
4199,269.75,689,422,267,0.467
4200,50.25,2,1,1,1.996
4201,217.75,701,452,249,0.395
4202,15.25,0,0,0,2
4203,261.25,656,412,244,0.52
4204,238.75,650,423,227,0.504
4205,322.5,655,424,231,0.497
4206,270.5,672,435,237,0.458
4207,248.5,694,432,262,0.442
4208,19,0,0,0,2
4209,303.25,654,426,228,0.494
4210,290.75,708,437,271,0.418
4211,260,634,419,215,0.528
4212,24,1,0,1,1.999
4213,3.5,0,0,0,2
4214,215.5,687,441,246,0.431
4215,320.25,673,419,254,0.489
4216,217.5,634,423,211,0.52
4217,15.25,0,0,0,2
4218,6.5,0,0,0,2
4219,18.25,1,1,0,1.997
4220,13.5,0,0,0,2
4221,254.25,690,442,248,0.426
4222,19,0,0,0,2
4223,279,678,431,247,0.46
4224,287.75,697,444,253,0.415
4225,230.75,693,445,248,0.417
4226,22,1,1,0,1.997
4227,16,1,0,1,1.999
4228,28.25,4,2,2,1.992
4229,49.25,3,3,0,1.991
4230,6,0,0,0,2
4231,286.5,665,429,236,0.477
4232,11.75,0,0,0,2
4233,265,706,443,263,0.408
4234,243,678,439,239,0.444
4235,287.75,720,451,269,0.378
4236,262.75,677,434,243,0.455
4237,294,678,432,246,0.458
4238,198.75,698,435,263,0.432
4239,7.5,0,0,0,2
4240,256,673,445,228,0.437
4241,303.5,692,430,262,0.448
4242,23.25,0,0,0,2
4243,199.5,645,403,242,0.549
4244,303,687,448,239,0.417
4245,38,4,2,2,1.992
4246,248.5,656,424,232,0.496
4247,258.75,649,433,216,0.485
4248,222.75,696,430,266,0.444
4249,275.5,697,442,255,0.419
4250,294.25,670,415,255,0.5
4251,289.75,678,420,258,0.482
4252,11.25,0,0,0,2
4253,241.5,666,421,245,0.492
4254,19.5,0,0,0,2
4255,50.75,3,3,0,1.991
4256,6.5,0,0,0,2
4257,198.5,739,455,284,0.351
4258,12.75,0,0,0,2
4259,270,651,430,221,0.489
4260,6,0,0,0,2
4261,248.25,668,435,233,0.462
4262,12,0,0,0,2
4263,305,685,444,241,0.427
4264,209.75,707,447,260,0.399
4265,270.5,665,428,237,0.479
4266,248.25,647,416,231,0.521
4267,249.5,661,421,240,0.497
4268,9,0,0,0,2
4269,247.5,688,439,249,0.434
4270,233.75,680,448,232,0.424
4271,9.5,0,0,0,2
4272,275.75,704,447,257,0.402
4273,254,678,438,240,0.446
4274,6.75,0,0,0,2
4275,76.75,5,3,2,1.989
4276,255.5,694,446,248,0.414
4277,32,0,0,0,2
4278,331,694,435,259,0.436
4279,325.5,673,427,246,0.473
4280,25.25,1,1,0,1.997
4281,23,0,0,0,2
4282,218.25,681,439,242,0.441
4283,25.75,0,0,0,2
4284,48.75,5,2,3,1.991
4285,254.25,651,420,231,0.509
4286,17.25,0,0,0,2
4287,266.75,688,441,247,0.43
4288,38,3,2,1,1.993
4289,317.5,691,438,253,0.433
4290,250,709,450,259,0.391
4291,245,713,451,262,0.385
4292,245.5,692,442,250,0.424
4293,22.75,1,1,0,1.997
4294,261.75,678,435,243,0.452
4295,24.25,1,1,0,1.997
4296,276.5,674,433,241,0.46
4297,6,0,0,0,2
4298,267.25,695,441,254,0.423
4299,13.5,0,0,0,2
4300,255.75,704,437,267,0.422
4301,300.5,631,413,218,0.543
4302,250,674,431,243,0.464
4303,20.25,1,1,0,1.997
4304,218.5,669,435,234,0.461
4305,271.25,667,416,251,0.501
4306,261.25,675,423,252,0.479
4307,263.5,700,448,252,0.404
4308,18.25,0,0,0,2
4309,293.75,667,433,234,0.467
4310,360.5,659,436,223,0.469
4311,18.25,0,0,0,2
4312,420.25,655,422,233,0.501
4313,213.75,680,441,239,0.438
4314,227.5,684,439,245,0.438
4315,290.5,680,440,240,0.44
4316,321.25,660,427,233,0.486
4317,12.25,0,0,0,2
4318,287.75,661,414,247,0.511
4319,256.75,696,441,255,0.422
4320,259.25,675,436,239,0.453
4321,222.25,666,437,229,0.46
4322,256.5,725,455,270,0.365
4323,243.5,724,457,267,0.362
4324,21.75,0,0,0,2
4325,269.25,655,435,220,0.475
4326,56.25,3,2,1,1.993
4327,241.75,655,423,232,0.499
4328,248,644,417,227,0.522
4329,231.5,670,434,236,0.462
4330,295,667,425,242,0.483
4331,13,0,0,0,2
4332,252,717,446,271,0.391
4333,218.25,653,417,236,0.513
4334,276.5,687,434,253,0.445
4335,233.75,674,426,248,0.474
4336,9,0,0,0,2
4337,332.25,663,427,236,0.483
4338,266.25,703,443,260,0.411
4339,29,1,1,0,1.997
4340,277.25,658,420,238,0.502
4341,5.75,0,0,0,2
4342,252.5,686,435,251,0.444
4343,350.25,700,442,258,0.416
4344,260.25,707,444,263,0.405
4345,237,726,448,278,0.378
4346,221.5,700,448,252,0.404
4347,283.25,709,441,268,0.409
4348,290,714,455,259,0.376
4349,247,699,446,253,0.409
4350,19.75,1,1,0,1.997
4351,29.25,0,0,0,2
4352,250.75,703,451,252,0.395
4353,7.75,0,0,0,2
4354,281.75,634,413,221,0.54
4355,75.25,9,5,4,1.981
4356,24.25,0,0,0,2
4357,269.25,653,421,232,0.505
4358,241.75,672,434,238,0.46
4359,256,674,424,250,0.478
4360,26.75,2,2,0,1.994
4361,216,709,437,272,0.417
4362,230.5,696,442,254,0.42
4363,9.25,0,0,0,2
4364,14.25,0,0,0,2
4365,236.5,744,451,293,0.354
4366,248.5,709,433,276,0.425
4367,19,0,0,0,2
4368,268.25,679,442,237,0.437
4369,10,0,0,0,2
4370,295.25,695,450,245,0.405
4371,289.5,646,410,236,0.534
4372,39.75,3,1,2,1.995
4373,281.25,630,406,224,0.558
4374,20,1,0,1,1.999
4375,37.5,0,0,0,2
4376,25.25,2,1,1,1.996
4377,7.25,0,0,0,2
4378,53.75,2,0,2,1.998
4379,17.5,0,0,0,2
4380,22.5,1,1,0,1.997
4381,15.75,0,0,0,2
4382,26,3,3,0,1.991
4383,176.25,640,411,229,0.538
4384,237,721,450,271,0.379
4385,314,695,434,261,0.437
4386,215.75,688,442,246,0.428
4387,23.5,0,0,0,2
4388,238,671,436,235,0.457
4389,265.75,653,429,224,0.489
4390,220.5,681,436,245,0.447
4391,264.75,668,428,240,0.476
4392,268.25,700,435,265,0.43
4393,232,675,436,239,0.453
4394,351.25,700,453,247,0.394
4395,22.75,1,0,1,1.999
4396,34,2,2,0,1.994
4397,20,1,1,0,1.997
4398,7.25,0,0,0,2
4399,229.5,653,418,235,0.511
4400,309.75,677,420,257,0.483
4401,19,0,0,0,2
4402,234.5,719,453,266,0.375
4403,9,0,0,0,2
4404,304.25,684,428,256,0.46
4405,54,3,2,1,1.993
4406,283,729,443,286,0.385
4407,276.75,682,440,242,0.438
4408,263.25,630,415,215,0.54
4409,268.25,675,446,229,0.433
4410,11.25,0,0,0,2
4411,10.5,0,0,0,2
4412,44,4,4,0,1.988
4413,4.25,0,0,0,2
4414,255.5,698,442,256,0.418
4415,17,1,0,1,1.999
4416,268.75,680,427,253,0.466
4417,21.75,2,1,1,1.996
4418,36.5,1,1,0,1.997
4419,14,0,0,0,2
4420,221.25,669,426,243,0.479
4421,237.5,685,432,253,0.451
4422,18.5,0,0,0,2
4423,259.25,693,431,262,0.445
4424,238.5,712,439,273,0.41
4425,271.25,667,437,230,0.459
4426,244.25,662,431,231,0.476
4427,261.75,648,416,232,0.52
4428,294.75,651,428,223,0.493
4429,237.25,664,429,235,0.478
4430,16.75,1,1,0,1.997
4431,14,0,0,0,2
4432,251,677,437,240,0.449
4433,249.25,731,452,279,0.365
4434,288.25,589,393,196,0.625
4435,17.5,0,0,0,2
4436,286.25,697,436,261,0.431
4437,334.75,681,438,243,0.443
4438,30.5,2,2,0,1.994
4439,282.75,669,426,243,0.479
4440,315,690,438,252,0.434
4441,253.75,704,450,254,0.396
4442,38.25,3,3,0,1.991
4443,250.5,714,441,273,0.404
4444,288.5,705,444,261,0.407
4445,289,692,447,245,0.414
4446,10.25,0,0,0,2
4447,34.75,2,2,0,1.994
4448,232.25,726,454,272,0.366
4449,314.75,696,442,254,0.42
4450,259.25,649,420,229,0.511
4451,27.25,1,0,1,1.999
4452,39.5,2,1,1,1.996
4453,23,0,0,0,2
4454,310.25,679,439,240,0.443
4455,318.25,638,429,209,0.504
4456,276.75,657,425,232,0.493
4457,214.25,662,434,228,0.47
4458,228,696,439,257,0.426
4459,283.5,694,430,264,0.446
4460,338.25,673,433,240,0.461
4461,407.75,672,431,241,0.466
4462,315.5,641,405,236,0.549
4463,219,653,437,216,0.473
4464,239.5,688,442,246,0.428
4465,243.5,649,419,230,0.513
4466,339.5,668,419,249,0.494
4467,276.75,673,432,241,0.463
4468,19.25,0,0,0,2
4469,33.5,1,1,0,1.997
4470,31.75,0,0,0,2
4471,293,709,443,266,0.405
4472,242,664,426,238,0.484
4473,14,0,0,0,2
4474,268.75,676,433,243,0.458
4475,13.25,0,0,0,2
4476,225.75,708,444,264,0.404
4477,32.75,0,0,0,2
4478,13.75,0,0,0,2
4479,17,0,0,0,2
4480,7.25,0,0,0,2
4481,253.25,694,435,259,0.436
4482,274,740,454,286,0.352
4483,203.25,684,433,251,0.45
4484,36.25,0,0,0,2
4485,10.75,0,0,0,2
4486,198.75,733,453,280,0.361
4487,36.25,1,1,0,1.997
4488,234.25,660,430,230,0.48
4489,16.75,0,0,0,2
4490,233.75,726,451,275,0.372
4491,278,683,428,255,0.461
4492,261.5,696,437,259,0.43
4493,260,642,410,232,0.538
4494,252.25,699,436,263,0.429
4495,31.75,3,2,1,1.993
4496,209.25,679,439,240,0.443
4497,253.5,703,444,259,0.409
4498,7,1,0,1,1.999
4499,254.5,706,445,261,0.404
4500,26.75,1,0,1,1.999
4501,16,1,1,0,1.997
4502,5.5,0,0,0,2
4503,227,665,426,239,0.483
4504,16,0,0,0,2
4505,284,682,436,246,0.446
4506,256.75,673,436,237,0.455
4507,10.75,0,0,0,2
4508,7.75,0,0,0,2
4509,415.25,703,435,268,0.427
4510,297.75,705,446,259,0.403
4511,250.5,672,427,245,0.474
4512,324,673,434,239,0.459
4513,300.25,632,412,220,0.544
4514,278,741,459,282,0.341
4515,6,0,0,0,2
4516,251.5,692,427,265,0.454
4517,37.25,4,3,1,1.99
4518,234.5,663,428,235,0.481
4519,318.25,650,424,226,0.502
4520,234.25,700,445,255,0.41
4521,17.25,0,0,0,2
4522,254,677,423,254,0.477
4523,305.5,729,446,283,0.379
4524,207.25,640,420,220,0.52
4525,227.5,690,445,245,0.42
4526,214,732,450,282,0.368
4527,42.25,0,0,0,2
4528,22,2,2,0,1.994
4529,12.75,0,0,0,2
4530,250.25,677,436,241,0.451
4531,230.25,690,440,250,0.43
4532,19,0,0,0,2
4533,293.75,669,419,250,0.493
4534,288.25,696,442,254,0.42
4535,236,706,441,265,0.412
4536,5.5,0,0,0,2
4537,291.75,695,432,263,0.441
4538,20.25,1,0,1,1.999
4539,28.75,2,2,0,1.994
4540,352.75,668,436,232,0.46
4541,38,1,1,0,1.997
4542,259.25,673,427,246,0.473
4543,294.25,612,405,207,0.578
4544,276.25,711,446,265,0.397
4545,24.25,1,1,0,1.997
4546,300.75,682,441,241,0.436
4547,292,651,414,237,0.521
4548,6.25,0,0,0,2
4549,239.75,640,417,223,0.526
4550,271.25,663,438,225,0.461
4551,258.25,710,447,263,0.396
4552,265.5,726,443,283,0.388
4553,11,1,1,0,1.997
4554,231,698,443,255,0.416
4555,13.25,0,0,0,2
4556,264.25,618,405,213,0.572
4557,282.5,623,414,209,0.549
4558,274.25,765,454,311,0.327
4559,273.75,652,430,222,0.488
4560,247.25,658,438,220,0.466
4561,330,671,427,244,0.475
4562,4.5,0,0,0,2
4563,276.75,675,437,238,0.451
4564,336,683,432,251,0.453
4565,16.75,1,0,1,1.999
4566,279.75,669,436,233,0.459
4567,239.25,703,443,260,0.411
4568,9,0,0,0,2
4569,332.25,711,452,259,0.385
4570,266.75,658,423,235,0.496
4571,5.25,0,0,0,2
4572,262.25,619,419,200,0.543
4573,26.25,1,0,1,1.999
4574,259,668,426,242,0.48
4575,29.5,2,2,0,1.994
4576,304,702,450,252,0.398
4577,325.25,658,428,230,0.486
4578,257,674,427,247,0.472
4579,311.5,649,412,237,0.527
4580,7,0,0,0,2
4581,240.25,634,421,213,0.524
4582,257.75,687,441,246,0.431
4583,33.5,4,3,1,1.99
4584,238.5,684,427,257,0.462
4585,304,676,434,242,0.456
4586,338.5,614,412,202,0.562
4587,66.25,5,5,0,1.985
4588,252.25,725,457,268,0.361
4589,316.5,716,443,273,0.398
4590,229,725,450,275,0.375
4591,317,661,430,231,0.479
4592,261.25,689,439,250,0.433
4593,10.5,0,0,0,2
4594,254.5,699,436,263,0.429
4595,23.25,0,0,0,2
4596,264.75,691,445,246,0.419
4597,235.25,660,423,237,0.494
4598,227.75,730,456,274,0.358
4599,264,661,431,230,0.477
4600,209.5,718,452,266,0.378
4601,252.5,728,452,276,0.368
4602,271.75,707,449,258,0.395
4603,25.5,1,0,1,1.999
4604,49,0,0,0,2
4605,16.75,0,0,0,2
4606,16,0,0,0,2
4607,8.25,0,0,0,2
4608,284.25,654,418,236,0.51
4609,263.25,714,440,274,0.406
4610,244,708,441,267,0.41
4611,21.75,0,0,0,2
4612,260.5,716,453,263,0.378
4613,282,724,448,276,0.38
4614,31,1,1,0,1.997
4615,66.25,3,2,1,1.993
4616,14.5,0,0,0,2
4617,9.25,0,0,0,2
4618,209.75,719,439,280,0.403
4619,256.75,679,426,253,0.469
4620,297,681,433,248,0.453
4621,8.5,0,0,0,2
4622,275.75,697,441,256,0.421
4623,10.5,0,0,0,2
4624,269.25,682,437,245,0.444
4625,252.5,685,424,261,0.467
4626,260.5,665,423,242,0.489
4627,257.75,675,434,241,0.457
4628,256,660,434,226,0.472
4629,239.5,655,418,237,0.509
4630,223.25,685,433,252,0.449
4631,304.75,650,425,225,0.5
4632,53.75,3,3,0,1.991
4633,13.75,0,0,0,2
4634,287.25,681,430,251,0.459
4635,215.75,675,423,252,0.479
4636,208,743,465,278,0.327
4637,248.5,723,449,274,0.379
4638,53,4,3,1,1.99
4639,19.25,0,0,0,2
4640,285.5,678,434,244,0.454
4641,276.75,721,459,262,0.361
4642,250.5,672,425,247,0.478
4643,18,0,0,0,2
4644,216.25,705,443,262,0.409
4645,278.25,680,438,242,0.444
4646,9.5,0,0,0,2
4647,257.25,677,438,239,0.447
4648,279.75,660,413,247,0.514
4649,274.75,703,443,260,0.411
4650,12.25,0,0,0,2
4651,15.75,0,0,0,2
4652,14.25,0,0,0,2
4653,298.75,678,439,239,0.444
4654,342.25,670,417,253,0.496
4655,270.5,702,434,268,0.43
4656,57.5,2,1,1,1.996
4657,343.75,720,458,262,0.364
4658,7.25,0,0,0,2
4659,247.25,684,446,238,0.424
4660,274.75,683,431,252,0.455
4661,7.25,0,0,0,2
4662,358.25,665,434,231,0.467
4663,297.25,712,447,265,0.394
4664,283.5,668,423,245,0.486
4665,274,676,427,249,0.47
4666,272.25,642,414,228,0.53
4667,25.5,0,0,0,2
4668,264,673,432,241,0.463
4669,275.5,667,424,243,0.485
4670,244,663,429,234,0.479
4671,260,735,449,286,0.367
4672,9.75,0,0,0,2
4673,20.5,0,0,0,2
4674,25.5,0,0,0,2
4675,277.25,701,434,267,0.431
4676,310.5,689,437,252,0.437
4677,28.75,1,1,0,1.997
4678,32.5,1,1,0,1.997
4679,232.5,704,448,256,0.4
4680,228.5,725,445,280,0.385
4681,251,679,436,243,0.449
4682,15.5,1,1,0,1.997
4683,286.25,660,430,230,0.48
4684,250,666,430,236,0.474
4685,265.75,686,443,243,0.428
4686,273,681,435,246,0.449
4687,261.5,649,413,236,0.525
4688,18.25,0,0,0,2
4689,270.5,660,432,228,0.476
4690,246.5,633,412,221,0.543
4691,15.75,0,0,0,2
4692,15,0,0,0,2
4693,301.75,672,427,245,0.474
4694,10.25,0,0,0,2
4695,229.75,675,438,237,0.449
4696,33.25,2,2,0,1.994
4697,315,716,443,273,0.398
4698,32.75,1,1,0,1.997
4699,8.5,0,0,0,2
4700,14,0,0,0,2
4701,8.5,0,0,0,2
4702,7,0,0,0,2
4703,258,683,431,252,0.455
4704,253.5,674,430,244,0.466
4705,13,0,0,0,2
4706,288.5,680,429,251,0.462
4707,259.25,674,433,241,0.46
4708,15.75,0,0,0,2
4709,236,618,406,212,0.57
4710,290.5,692,435,257,0.438
4711,263,662,442,220,0.454
4712,223.5,695,435,260,0.435
4713,330.25,704,441,263,0.414
4714,321.75,645,421,224,0.513
4715,242,711,447,264,0.395
4716,282.25,670,433,237,0.464
4717,280.75,671,418,253,0.493
4718,232.75,690,441,249,0.428
4719,244,705,447,258,0.401
4720,30.5,0,0,0,2
4721,11.5,0,0,0,2
4722,29.5,2,2,0,1.994
4723,270,700,446,254,0.408
4724,337.5,739,464,275,0.333
4725,261.25,705,442,263,0.411
4726,325.25,665,422,243,0.491
4727,36.75,2,2,0,1.994
4728,10.5,0,0,0,2
4729,304.5,666,425,241,0.484
4730,33.75,1,1,0,1.997
4731,301.75,714,448,266,0.39
4732,308,700,444,256,0.412
4733,226.75,630,420,210,0.53
4734,10.25,0,0,0,2
4735,3.5,0,0,0,2
4736,39.5,3,2,1,1.993
4737,285.75,734,446,288,0.374
4738,272.75,717,447,270,0.389
4739,24.25,0,0,0,2
4740,9,0,0,0,2
4741,12.5,0,0,0,2
4742,251.5,745,457,288,0.341
4743,271.5,684,439,245,0.438
4744,303.75,648,410,238,0.532
4745,226.5,634,408,226,0.55
4746,26.5,1,1,0,1.997
4747,251.25,621,409,212,0.561
4748,262.25,672,437,235,0.454
4749,256,674,429,245,0.468
4750,20,0,0,0,2
4751,273,665,426,239,0.483
4752,232.25,658,430,228,0.482
4753,21.5,0,0,0,2
4754,4.25,0,0,0,2
4755,283,641,424,217,0.511
4756,257.25,656,423,233,0.498
4757,247.75,689,437,252,0.437
4758,6.75,0,0,0,2
4759,33.75,1,1,0,1.997
4760,247,688,430,258,0.452
4761,242.25,695,439,256,0.427
4762,343.75,668,429,239,0.474
4763,299.5,669,437,232,0.457
4764,9,0,0,0,2
4765,289.25,687,438,249,0.437
4766,199.75,611,413,198,0.563
4767,230.5,730,451,279,0.368
4768,22.25,0,0,0,2
4769,34.25,2,1,1,1.996
4770,318.25,680,438,242,0.444
4771,58,3,3,0,1.991
4772,25.25,0,0,0,2
4773,46.75,1,0,1,1.999
4774,29.5,5,4,1,1.987
4775,306,725,450,275,0.375
4776,224.75,689,437,252,0.437
4777,301.5,634,409,225,0.548
4778,257.75,697,441,256,0.421
4779,321,660,440,220,0.46
4780,232.75,686,442,244,0.43
4781,215.5,667,430,237,0.473
4782,253.5,697,440,257,0.423
4783,333.75,695,435,260,0.435
4784,346.75,683,430,253,0.457
4785,253.5,685,439,246,0.437
4786,226.5,677,425,252,0.473
4787,32.75,1,1,0,1.997
4788,15.5,1,1,0,1.997
4789,16.25,0,0,0,2
4790,9,0,0,0,2
4791,16.75,0,0,0,2
4792,20.5,0,0,0,2
4793,274.75,686,439,247,0.436
4794,20.75,1,1,0,1.997
4795,256.5,679,444,235,0.433
4796,281.25,702,435,267,0.428
4797,268.25,682,425,257,0.468
4798,30.75,3,3,0,1.991
4799,322.25,730,457,273,0.356
4800,326.5,618,410,208,0.562
4801,6.5,0,0,0,2
4802,15.75,0,0,0,2
4803,260.25,688,438,250,0.436
4804,40,0,0,0,2
4805,229.5,734,458,276,0.35
4806,350.5,674,434,240,0.458
4807,16.25,0,0,0,2
4808,283.75,671,433,238,0.463
4809,62,5,5,0,1.985
4810,269.5,703,440,263,0.417
4811,33.75,2,2,0,1.994
4812,292.25,663,422,241,0.493
4813,270.25,658,416,242,0.51
4814,273.75,735,461,274,0.343
4815,43.5,0,0,0,2
4816,26.5,4,4,0,1.988
4817,227.5,668,428,240,0.476
4818,283.5,689,434,255,0.443
4819,310,695,432,263,0.441
4820,217.25,680,431,249,0.458
4821,227.25,688,432,256,0.448
4822,16,0,0,0,2
4823,34.5,1,1,0,1.997
4824,270.25,677,428,249,0.467
4825,13.75,0,0,0,2
4826,209,723,446,277,0.385
4827,234.5,732,452,280,0.364
4828,8.25,0,0,0,2
4829,34,4,3,1,1.99
4830,294.5,645,413,232,0.529
4831,19.5,0,0,0,2
4832,16.25,0,0,0,2
4833,303.5,724,444,280,0.388
4834,48.25,2,2,0,1.994
4835,255.25,646,417,229,0.52
4836,269.25,667,434,233,0.465
4837,208.5,716,446,270,0.392
4838,304.75,683,438,245,0.441
4839,201.25,718,444,274,0.394
4840,270.5,724,452,272,0.372
4841,6.5,0,0,0,2
4842,216.75,670,439,231,0.452
4843,353.75,699,442,257,0.417
4844,248.25,706,436,270,0.422
4845,340,655,419,236,0.507
4846,274,653,421,232,0.505
4847,260,675,424,251,0.477
4848,265,680,436,244,0.448
4849,252.25,679,440,239,0.441
4850,274.75,613,406,207,0.575
4851,281.25,671,434,237,0.461
4852,297.75,689,437,252,0.437
4853,32,1,1,0,1.997
4854,300,656,425,231,0.494
4855,341.5,640,426,214,0.508
4856,248.75,638,432,206,0.498
4857,10.75,0,0,0,2
4858,252.5,679,430,249,0.461
4859,280.25,633,419,214,0.529
4860,243,692,445,247,0.418
4861,24,3,3,0,1.991
4862,330.25,668,416,252,0.5
4863,284.75,700,439,261,0.422
4864,2.25,0,0,0,2
4865,16.25,0,0,0,2
4866,351.25,686,436,250,0.442
4867,315.75,695,439,256,0.427
4868,276.5,750,459,291,0.332
4869,233.5,708,450,258,0.392
4870,11,0,0,0,2
4871,53,2,2,0,1.994
4872,276.5,666,427,239,0.48
4873,202.25,648,422,226,0.508
4874,277.25,718,454,264,0.374
4875,40,1,1,0,1.997
4876,260.5,668,416,252,0.5
4877,271,676,440,236,0.444
4878,19.25,0,0,0,2
4879,252.25,713,448,265,0.391
4880,304.5,677,433,244,0.457
4881,264.25,641,412,229,0.535
4882,283.5,688,436,252,0.44
4883,311.5,672,437,235,0.454
4884,369,644,436,208,0.484
4885,15.5,0,0,0,2
4886,270.25,638,408,230,0.546
4887,260.25,678,445,233,0.432
4888,236.75,696,449,247,0.406
4889,334,707,458,249,0.377
4890,238.25,668,427,241,0.478
4891,19.5,0,0,0,2
4892,239.75,662,423,239,0.492
4893,17.5,0,0,0,2
4894,265.75,666,428,238,0.478
4895,250.25,647,422,225,0.509
4896,212,693,446,247,0.415
4897,314.75,627,413,214,0.547
4898,231.75,645,421,224,0.513
4899,258.75,706,449,257,0.396
4900,266.5,683,442,241,0.433
4901,71.25,4,3,1,1.99
4902,289.25,720,454,266,0.372
4903,16.75,1,1,0,1.997
4904,234,688,425,263,0.462
4905,263.75,708,453,255,0.386
4906,39.75,2,1,1,1.996
4907,216.5,709,446,263,0.399
4908,280.75,694,444,250,0.418
4909,222,681,426,255,0.467
4910,263.25,651,421,230,0.507
4911,20.25,0,0,0,2
4912,205.75,669,424,245,0.483
4913,318.25,686,431,255,0.452
4914,222.75,684,444,240,0.428
4915,274,650,420,230,0.51
4916,265.5,700,445,255,0.41
4917,328.5,694,431,263,0.444
4918,320.5,659,417,242,0.507
4919,16.25,0,0,0,2
4920,12.25,0,0,0,2
4921,17,0,0,0,2
4922,286.25,683,426,257,0.465
4923,250.75,666,429,237,0.476
4924,243.25,682,421,261,0.476
4925,10.75,0,0,0,2
4926,19.25,2,1,1,1.996
4927,7.25,0,0,0,2
4928,219,679,430,249,0.461
4929,11.25,0,0,0,2
4930,299.25,674,441,233,0.444
4931,255.5,645,420,225,0.515
4932,17.5,0,0,0,2
4933,333.5,693,441,252,0.425
4934,219.5,647,426,221,0.501
4935,282.5,682,444,238,0.43
4936,230.25,699,432,267,0.437
4937,40.25,2,0,2,1.998
4938,10.75,0,0,0,2
4939,267,693,428,265,0.451
4940,275.75,685,425,260,0.465
4941,282,657,416,241,0.511
4942,294.5,687,434,253,0.445
4943,251.5,672,428,244,0.472
4944,259,717,450,267,0.383
4945,237.25,691,434,257,0.441
4946,262.5,687,433,254,0.447
4947,251.25,681,439,242,0.441
4948,214.75,664,421,243,0.494
4949,246.75,665,433,232,0.469
4950,290.25,692,442,250,0.424
4951,233.75,713,449,264,0.389
4952,214.25,663,429,234,0.479
4953,16.75,0,0,0,2
4954,207.75,698,451,247,0.4
4955,247.5,661,440,221,0.459
4956,278,625,405,220,0.565
4957,7.5,0,0,0,2
4958,301.5,649,427,222,0.497
4959,226,666,442,224,0.45
4960,18,0,0,0,2
4961,316.75,701,440,261,0.419
4962,21.5,1,0,1,1.999
4963,253.75,661,422,239,0.495
4964,56.25,4,3,1,1.99
4965,244,691,440,251,0.429
4966,4.75,0,0,0,2
4967,214.75,685,437,248,0.441
4968,252.5,676,435,241,0.454
4969,254.75,705,450,255,0.395
4970,22.5,0,0,0,2
4971,37.75,0,0,0,2
4972,288.5,633,424,209,0.519
4973,296.25,721,448,273,0.383
4974,10,0,0,0,2
4975,21,0,0,0,2
4976,340.75,682,430,252,0.458
4977,19.5,1,0,1,1.999
4978,17,0,0,0,2
4979,283.25,693,435,258,0.437
4980,12.25,0,0,0,2
4981,225.25,707,458,249,0.377
4982,8.25,0,0,0,2
4983,12.75,0,0,0,2
4984,257.25,736,454,282,0.356
4985,16.5,0,0,0,2
4986,283,697,442,255,0.419
4987,266.75,672,427,245,0.474
4988,186.25,694,431,263,0.444
4989,255.25,680,433,247,0.454
4990,258.25,721,444,277,0.391
4991,241.75,653,418,235,0.511
4992,252,667,429,238,0.475
4993,251,684,435,249,0.446
4994,307.25,721,461,260,0.357
4995,4,0,0,0,2
4996,277.25,667,426,241,0.481
4997,340.5,686,439,247,0.436
4998,231.25,660,431,229,0.478
4999,17.75,0,0,0,2
5000,305,712,457,255,0.374
5001,6.25,0,0,0,2
5002,291.5,691,435,256,0.439
5003,16.75,0,0,0,2
5004,389.25,662,414,248,0.51
5005,291.5,704,451,253,0.394
5006,292.25,676,440,236,0.444
5007,324,719,456,263,0.369
5008,360,674,433,241,0.46
5009,284.5,728,458,270,0.356
5010,92.5,10,8,2,1.974
5011,27.75,1,1,0,1.997
5012,260.75,712,454,258,0.38
5013,329.75,660,427,233,0.486
5014,372.75,668,430,238,0.472
5015,286.5,717,435,282,0.413
5016,16,0,0,0,2
5017,12.5,0,0,0,2
5018,14.25,0,0,0,2
5019,90.5,14,10,4,1.966
5020,355.75,728,448,280,0.376
5021,19.5,0,0,0,2
5022,276.75,734,446,288,0.374
5023,9.5,0,0,0,2
5024,241,678,429,249,0.464
5025,246.5,629,421,208,0.529
5026,13,0,0,0,2
5027,270,684,436,248,0.444
5028,294.25,669,441,228,0.449
5029,13.75,0,0,0,2
5030,253.25,663,431,232,0.475
5031,259.5,681,433,248,0.453
5032,254.5,707,446,261,0.401
5033,243,697,440,257,0.423
5034,11.5,0,0,0,2
5035,262.5,689,439,250,0.433
5036,303.5,717,448,269,0.387
5037,261.25,688,432,256,0.448
5038,249.75,681,432,249,0.455
5039,3.25,0,0,0,2
5040,199.25,730,459,271,0.352
5041,226.25,673,434,239,0.459
5042,322.5,664,429,235,0.478
5043,216.75,711,444,267,0.401
5044,225.25,686,437,249,0.44
5045,230.75,719,444,275,0.393
5046,32,0,0,0,2
5047,272.5,676,435,241,0.454
5048,49.25,3,1,2,1.995
5049,213,691,441,250,0.427
5050,37.25,1,1,0,1.997
5051,318,679,431,248,0.459
5052,239.75,698,442,256,0.418
5053,235.75,626,411,215,0.552
5054,239,683,432,251,0.453
5055,234.75,659,428,231,0.485
5056,292.5,685,443,242,0.429
5057,335,701,437,264,0.425
5058,230.75,684,431,253,0.454
5059,229.25,689,442,247,0.427
5060,259.25,685,451,234,0.413
5061,330.25,682,439,243,0.44
5062,10.75,0,0,0,2
5063,14,0,0,0,2
5064,274.25,655,424,231,0.497
5065,35.5,4,3,1,1.99
5066,261.25,675,439,236,0.447
5067,343.25,689,440,249,0.431
5068,240.5,707,453,254,0.387
5069,211.5,690,445,245,0.42
5070,565,647,424,223,0.505
5071,341.25,703,451,252,0.395
5072,277,649,421,228,0.509
5073,35,1,1,0,1.997
5074,338,655,423,232,0.499
5075,277.75,668,429,239,0.474
5076,234.25,685,446,239,0.423
5077,304.75,660,411,249,0.518
5078,284.75,712,441,271,0.406
5079,271.25,698,441,257,0.42
5080,260.25,710,444,266,0.402
5081,287.75,658,421,237,0.5
5082,15,0,0,0,2
5083,275.25,659,417,242,0.507
5084,6.75,0,0,0,2
5085,25.75,0,0,0,2
5086,5.5,0,0,0,2
5087,4.5,0,0,0,2
5088,71.75,8,6,2,1.98
5089,269.5,675,427,248,0.471
5090,285.5,717,455,262,0.373
5091,34,1,0,1,1.999
5092,13.25,0,0,0,2
5093,20.25,0,0,0,2
5094,9.5,0,0,0,2
5095,261.75,699,436,263,0.429
5096,241.75,663,433,230,0.471
5097,252.5,703,444,259,0.409
5098,270.5,637,407,230,0.549
5099,248.25,641,420,221,0.519
5100,272.25,699,438,261,0.425
5101,6,0,0,0,2
5102,230.75,632,425,207,0.518
5103,14.5,0,0,0,2
5104,310.25,678,434,244,0.454
5105,299.5,677,428,249,0.467
5106,246,674,439,235,0.448
5107,26.25,0,0,0,2
5108,295.25,659,426,233,0.489
5109,268.25,699,439,260,0.423
5110,26.75,1,1,0,1.997
5111,14.75,0,0,0,2
5112,20.25,0,0,0,2
5113,57.75,4,3,1,1.99
5114,287.5,690,434,256,0.442
5115,14.75,0,0,0,2
5116,343.25,653,428,225,0.491
5117,262.75,698,444,254,0.414
5118,22.5,0,0,0,2
5119,269.75,678,435,243,0.452
5120,8.5,0,0,0,2
5121,5.75,0,0,0,2
5122,12.75,0,0,0,2
5123,5.75,0,0,0,2
5124,18.25,0,0,0,2
5125,294.5,687,438,249,0.437
5126,264,689,435,254,0.441
5127,58.5,5,4,1,1.987
5128,255,732,451,281,0.366
5129,218.5,694,425,269,0.456
5130,197,683,440,243,0.437
5131,277.5,728,446,282,0.38
5132,273.25,702,445,257,0.408
5133,30.25,0,0,0,2
5134,317.5,632,411,221,0.546
5135,8.75,0,0,0,2
5136,260.5,732,451,281,0.366
5137,15.25,0,0,0,2
5138,86.75,13,11,2,1.965
5139,250,639,425,214,0.511
5140,13.25,0,0,0,2
5141,303.25,679,441,238,0.439
5142,255.75,645,420,225,0.515
5143,235.25,741,452,289,0.355
5144,8.75,0,0,0,2
5145,271.25,650,419,231,0.512
5146,250,660,436,224,0.468
5147,320,656,422,234,0.5
5148,337,656,415,241,0.514
5149,284.25,682,438,244,0.442
5150,21,0,0,0,2
5151,218,676,421,255,0.482
5152,218.5,692,442,250,0.424
5153,209.5,664,435,229,0.466
5154,297.25,661,423,238,0.493
5155,20.75,0,0,0,2
5156,253.25,684,434,250,0.448
5157,7.25,0,0,0,2
5158,30.25,1,0,1,1.999
5159,21.75,0,0,0,2
5160,16,0,0,0,2
5161,31,1,0,1,1.999
5162,301.75,705,443,262,0.409
5163,34.75,1,1,0,1.997
5164,6.25,0,0,0,2
5165,298.25,648,419,229,0.514
5166,16.25,0,0,0,2
5167,27,0,0,0,2
5168,45.75,2,1,1,1.996
5169,284.75,679,436,243,0.449
5170,254.75,723,451,272,0.375
5171,266.25,706,450,256,0.394
5172,194,710,453,257,0.384
5173,267.5,677,447,230,0.429
5174,244.75,690,432,258,0.446
5175,254.5,636,426,210,0.512
5176,215,695,441,254,0.423
5177,293,679,435,244,0.451
5178,260.75,707,443,264,0.407
5179,306,705,451,254,0.393
5180,231.25,683,430,253,0.457
5181,24.75,0,0,0,2
5182,219.75,679,439,240,0.443
5183,3.25,0,0,0,2
5184,219.25,718,454,264,0.374
5185,18.75,0,0,0,2
5186,264.5,721,444,277,0.391
5187,16.75,0,0,0,2
5188,220.5,688,433,255,0.446
5189,18.25,0,0,0,2
5190,251.5,706,435,271,0.424
5191,16.5,0,0,0,2
5192,291.25,699,440,259,0.421
5193,203.25,710,443,267,0.404
5194,21.75,0,0,0,2
5195,276.75,659,426,233,0.489
5196,224.5,689,438,251,0.435
5197,253,707,442,265,0.409
5198,17.75,1,1,0,1.997
5199,7.5,0,0,0,2
5200,262,712,445,267,0.398
5201,284.5,714,447,267,0.392
5202,276.5,701,435,266,0.429
5203,276.25,670,423,247,0.484
5204,251.5,700,438,262,0.424
5205,256.75,667,438,229,0.457
5206,297.75,671,417,254,0.495
5207,5.75,0,0,0,2
5208,251.5,624,421,203,0.534
5209,44.5,1,1,0,1.997
5210,255.25,720,437,283,0.406
5211,267.75,693,446,247,0.415
5212,230.75,691,441,250,0.427
5213,7.25,0,0,0,2
5214,87.75,15,10,5,1.965
5215,294.5,670,430,240,0.47
5216,16.5,1,1,0,1.997
5217,269.25,683,435,248,0.447
5218,245.75,632,423,209,0.522
5219,197.25,666,428,238,0.478
5220,4.75,0,0,0,2
5221,28.25,1,1,0,1.997
5222,246.25,631,410,221,0.549
5223,287.25,706,450,256,0.394
5224,11,0,0,0,2
5225,252.25,655,429,226,0.487
5226,55.25,4,2,2,1.992
5227,219.75,690,445,245,0.42
5228,229.25,647,416,231,0.521
5229,234,711,438,273,0.413
5230,5.75,0,0,0,2
5231,282.5,676,434,242,0.456
5232,274,650,423,227,0.504
5233,231.25,688,440,248,0.432
5234,20.75,0,0,0,2
5235,210.75,652,430,222,0.488
5236,9,1,1,0,1.997
5237,11.5,0,0,0,2
5238,298.5,646,427,219,0.5
5239,6,0,0,0,2
5240,261.5,700,451,249,0.398
5241,13,0,0,0,2
5242,255,695,447,248,0.411
5243,289,671,424,247,0.481
5244,242.5,718,455,263,0.372
5245,8,0,0,0,2
5246,3.75,0,0,0,2
5247,15.25,1,1,0,1.997
5248,219,690,443,247,0.424
5249,9.25,0,0,0,2
5250,229.25,679,433,246,0.455
5251,262.25,702,438,264,0.422
5252,326.5,687,449,238,0.415
5253,15.5,0,0,0,2
5254,303.25,691,428,263,0.453
5255,16.75,0,0,0,2
5256,271,667,434,233,0.465
5257,7,0,0,0,2
5258,360,702,446,256,0.406
5259,270.75,686,439,247,0.436
5260,62,3,2,1,1.993
5261,228.75,694,445,249,0.416
5262,16.5,0,0,0,2
5263,226.25,680,429,251,0.462
5264,14.25,0,0,0,2
5265,22,0,0,0,2
5266,4.5,0,0,0,2
5267,251.75,678,424,254,0.474
5268,225.5,685,443,242,0.429
5269,220,696,439,257,0.426
5270,359.25,663,429,234,0.479
5271,325.75,689,436,253,0.439
5272,282.25,692,441,251,0.426
5273,22.75,1,0,1,1.999
5274,266.5,648,416,232,0.52
5275,101.5,11,10,1,1.969
5276,257.75,654,409,245,0.528
5277,250.25,716,450,266,0.384
5278,34,2,2,0,1.994
5279,234.75,650,425,225,0.5
5280,16.75,0,0,0,2
5281,326,691,427,264,0.455
5282,330.75,682,430,252,0.458
5283,286.75,651,426,225,0.497
5284,300,675,439,236,0.447
5285,254.75,729,448,281,0.375
5286,272.25,675,434,241,0.457
5287,209,666,432,234,0.47
5288,13.75,0,0,0,2
5289,4,0,0,0,2
5290,19,0,0,0,2
5291,14.5,1,1,0,1.997
5292,252.25,720,450,270,0.38
5293,61.25,10,6,4,1.978
5294,232.5,745,453,292,0.349
5295,229.25,695,446,249,0.413
5296,233.25,678,441,237,0.44
5297,361.5,693,422,271,0.463
5298,9.75,0,0,0,2
5299,16.75,0,0,0,2
5300,33,1,0,1,1.999
5301,298.5,673,430,243,0.467
5302,10.25,0,0,0,2
5303,243,641,417,224,0.525
5304,249,723,446,277,0.385
5305,245,668,428,240,0.476
5306,241.25,673,438,235,0.451
5307,23.5,0,0,0,2
5308,15.25,0,0,0,2
5309,333.25,649,431,218,0.489
5310,257.25,709,438,271,0.415
5311,6.25,0,0,0,2
5312,25.25,0,0,0,2
5313,248.25,692,432,260,0.444
5314,250,661,432,229,0.475
5315,46,3,2,1,1.993
5316,25,2,1,1,1.996
5317,242.75,677,451,226,0.421
5318,270.25,653,425,228,0.497
5319,255.75,677,419,258,0.485
5320,223.75,677,431,246,0.461
5321,319.25,698,441,257,0.42
5322,245,666,438,228,0.458
5323,13,0,0,0,2
5324,272.25,671,430,241,0.469
5325,19.5,0,0,0,2
5326,248.75,650,426,224,0.498
5327,221.5,680,433,247,0.454
5328,7.5,0,0,0,2
5329,283.5,708,442,266,0.408
5330,344.5,667,433,234,0.467
5331,21,1,1,0,1.997
5332,59.5,4,4,0,1.988
5333,226,691,438,253,0.433
5334,271.25,687,436,251,0.441
5335,285.5,713,454,259,0.379
5336,273.75,690,446,244,0.418
5337,34,2,1,1,1.996
5338,90.25,5,4,1,1.987
5339,8,0,0,0,2
5340,332.75,708,439,269,0.414
5341,256.5,712,440,272,0.408
5342,330.75,670,430,240,0.47
5343,291.5,721,450,271,0.379
5344,264,651,417,234,0.515
5345,12.5,0,0,0,2
5346,241.25,712,441,271,0.406
5347,226.5,700,452,248,0.396
5348,10.5,0,0,0,2
5349,4.5,0,0,0,2
5350,247,662,426,236,0.486
5351,250.75,612,414,198,0.56
5352,52.25,2,1,1,1.996
5353,308,698,430,268,0.442
5354,251.75,667,420,247,0.493
5355,16.75,0,0,0,2
5356,33,1,1,0,1.997
5357,11,0,0,0,2
5358,4.75,0,0,0,2
5359,15.75,0,0,0,2
5360,191.5,706,441,265,0.412
5361,11.5,0,0,0,2
5362,271,718,446,272,0.39
5363,8,0,0,0,2
5364,8.75,0,0,0,2
5365,235.25,664,431,233,0.474
5366,262.5,697,442,255,0.419
5367,296.75,690,439,251,0.432
5368,269,656,428,228,0.488
5369,208.75,673,427,246,0.473
5370,280.5,688,446,242,0.42
5371,247.5,687,439,248,0.435
5372,361.25,724,452,272,0.372
5373,250,647,417,230,0.519
5374,256,702,441,261,0.416
5375,334.75,639,406,233,0.549
5376,16.25,0,0,0,2
5377,285.5,708,433,275,0.426
5378,287.25,648,427,221,0.498
5379,24.5,0,0,0,2
5380,252.75,668,427,241,0.478
5381,217.5,745,448,297,0.359
5382,224.25,696,448,248,0.408
5383,250.25,687,446,241,0.421
5384,223,705,444,261,0.407
5385,33.5,1,0,1,1.999
5386,9.5,0,0,0,2
5387,302.75,701,443,258,0.413
5388,13.25,0,0,0,2
5389,233,721,451,270,0.377
5390,285.75,662,417,245,0.504
5391,283,666,419,247,0.496
5392,8.5,0,0,0,2
5393,306,653,433,220,0.481
5394,20,0,0,0,2
5395,255.75,699,434,265,0.433
5396,33.75,1,1,0,1.997
5397,246.75,690,443,247,0.424
5398,285.25,650,421,229,0.508
5399,250.75,661,433,228,0.473
5400,313,669,428,241,0.475
5401,43,1,1,0,1.997
5402,269.75,702,444,258,0.41
5403,40.25,1,0,1,1.999
5404,261,658,429,229,0.484
5405,267.75,709,442,267,0.407
5406,33.25,2,2,0,1.994
5407,268.25,688,437,251,0.438
5408,353.5,692,448,244,0.412
5409,249.75,663,419,244,0.499
5410,13.75,0,0,0,2
5411,249.5,671,425,246,0.479
5412,327,693,445,248,0.417
5413,25.75,2,1,1,1.996
5414,15.25,0,0,0,2
5415,26,2,2,0,1.994
5416,228.25,727,448,279,0.377
5417,318,693,442,251,0.423
5418,222.75,683,440,243,0.437
5419,231.5,638,411,227,0.54
5420,10.75,0,0,0,2
5421,28.5,1,1,0,1.997
5422,246.25,693,442,251,0.423
5423,305,725,450,275,0.375
5424,280.5,651,419,232,0.511
5425,241.25,674,434,240,0.458
5426,7.5,0,0,0,2
5427,263,650,418,232,0.514
5428,193.5,702,446,256,0.406
5429,268,657,423,234,0.497
5430,264.5,615,412,203,0.561
5431,234.5,733,456,277,0.355
5432,16,0,0,0,2
5433,278.5,698,439,259,0.424
5434,210.5,687,440,247,0.433
5435,321.75,709,445,264,0.401
5436,280,674,423,251,0.48
5437,293.75,707,441,266,0.411
5438,216.25,689,435,254,0.441
5439,254.5,639,417,222,0.527
5440,300.75,699,446,253,0.409
5441,236.75,703,442,261,0.413
5442,28,1,1,0,1.997
5443,273.25,695,437,258,0.431
5444,271.75,703,443,260,0.411
5445,226.25,680,429,251,0.462
5446,26.25,0,0,0,2
5447,258.75,655,419,236,0.507
5448,223.5,647,426,221,0.501
5449,11,0,0,0,2
5450,216.5,666,424,242,0.486
5451,260.75,658,423,235,0.496
5452,263,640,417,223,0.526
5453,12.25,0,0,0,2
5454,14.75,0,0,0,2
5455,36.5,2,2,0,1.994
5456,267.5,690,433,257,0.444
5457,216.75,678,424,254,0.474
5458,252.25,648,415,233,0.522
5459,267,708,449,259,0.394
5460,250.25,657,432,225,0.479
5461,265.25,692,431,261,0.446
5462,287.75,689,425,264,0.461
5463,245,684,440,244,0.436
5464,17.5,2,1,1,1.996
5465,12.75,1,1,0,1.997
5466,20.75,1,1,0,1.997
5467,20.25,2,2,0,1.994
5468,225.75,706,448,258,0.398
5469,365.25,678,416,262,0.49
5470,258,670,437,233,0.456
5471,265,698,433,265,0.436
5472,302.25,696,438,258,0.428
5473,24.75,0,0,0,2
5474,7.5,0,0,0,2
5475,41.25,2,0,2,1.998
5476,38.75,1,0,1,1.999
5477,328.75,650,423,227,0.504
5478,25,0,0,0,2
5479,24.75,1,1,0,1.997
5480,248.25,674,439,235,0.448
5481,219.25,684,434,250,0.448
5482,5.75,0,0,0,2
5483,14.25,0,0,0,2
5484,348.5,676,444,232,0.436
5485,9,0,0,0,2
5486,30.75,0,0,0,2
5487,286,708,457,251,0.378
5488,16.25,0,0,0,2
5489,236.5,714,458,256,0.37
5490,23.75,1,1,0,1.997
5491,255.75,712,437,275,0.414
5492,37.75,0,0,0,2
5493,290.75,656,418,238,0.508
5494,244.25,707,437,270,0.419
5495,44,0,0,0,2
5496,57.25,1,0,1,1.999
5497,323.5,702,436,266,0.426
5498,300.25,704,447,257,0.402
5499,317.75,704,441,263,0.414
5500,251.25,685,427,258,0.461
5501,10.5,0,0,0,2
5502,215.5,577,386,191,0.651
5503,279,716,454,262,0.376
5504,231.5,694,434,260,0.438
5505,296.75,615,397,218,0.591
5506,288.25,678,434,244,0.454
5507,274.5,684,429,255,0.458
5508,289,707,436,271,0.421
5509,292.25,692,431,261,0.446
5510,196.25,682,427,255,0.464
5511,6.25,0,0,0,2
5512,15.25,0,0,0,2
5513,239.75,708,453,255,0.386
5514,207.75,631,410,221,0.549
5515,218.5,675,439,236,0.447
5516,271.25,687,439,248,0.435
5517,208.25,714,440,274,0.406
5518,240,719,452,267,0.377
5519,16.5,0,0,0,2
5520,280.5,646,422,224,0.51
5521,275,699,441,258,0.419
5522,23,0,0,0,2
5523,280.25,671,437,234,0.455
5524,251.75,666,433,233,0.468
5525,241,727,447,280,0.379
5526,7,0,0,0,2
5527,334.25,665,427,238,0.481
5528,254.5,691,436,255,0.437
5529,301.25,674,428,246,0.47
5530,37,3,1,2,1.995
5531,263.75,670,428,242,0.474
5532,296.75,716,454,262,0.376
5533,255.25,641,420,221,0.519
5534,226.5,736,459,277,0.346
5535,22.25,0,0,0,2
5536,42.75,3,2,1,1.993
5537,282,645,411,234,0.533
5538,196.75,697,432,265,0.439
5539,7,0,0,0,2
5540,301.5,684,433,251,0.45
5541,265,716,445,271,0.394
5542,233,679,435,244,0.451
5543,237.75,687,425,262,0.463
5544,207,713,444,269,0.399
5545,23.25,0,0,0,2
5546,299,682,430,252,0.458
5547,293,684,434,250,0.448
5548,278.75,659,425,234,0.491
5549,12,0,0,0,2
5550,28.75,1,1,0,1.997
5551,248.5,671,424,247,0.481
5552,249,694,433,261,0.44
5553,28,1,1,0,1.997
5554,277.5,706,441,265,0.412
5555,258.5,701,443,258,0.413
5556,7,0,0,0,2
5557,18.5,0,0,0,2
5558,227.5,686,441,245,0.432
5559,10,0,0,0,2
5560,11.25,0,0,0,2
5561,285.75,659,431,228,0.479
5562,24.75,1,0,1,1.999
5563,26.25,0,0,0,2
5564,241.75,669,418,251,0.495
5565,250.5,716,449,267,0.386
5566,242.75,695,438,257,0.429
5567,52.25,4,3,1,1.99
5568,55,5,4,1,1.987
5569,289.75,678,433,245,0.456
5570,272.25,663,418,245,0.501
5571,266,614,417,197,0.552
5572,283.25,660,422,238,0.496
5573,350.25,682,450,232,0.418
5574,262.5,664,432,232,0.472
5575,254.5,701,441,260,0.417
5576,271,669,427,242,0.477
5577,290,641,405,236,0.549
5578,320.75,664,427,237,0.482
5579,7.75,0,0,0,2
5580,269.5,707,443,264,0.407
5581,9.75,0,0,0,2
5582,9.5,0,0,0,2
5583,13,0,0,0,2
5584,311.25,680,432,248,0.456
5585,237,656,433,223,0.478
5586,267.75,719,448,271,0.385
5587,266.25,724,447,277,0.382
5588,47,3,3,0,1.991
5589,287.5,690,434,256,0.442
5590,4.25,0,0,0,2
5591,237.75,720,442,278,0.396
5592,22.75,0,0,0,2
5593,284,694,434,260,0.438
5594,19.75,0,0,0,2
5595,269.25,696,453,243,0.398
5596,256.5,677,426,251,0.471
5597,311.25,683,434,249,0.449
5598,248.25,645,423,222,0.509
5599,217.75,660,435,225,0.47
5600,291.5,648,416,232,0.52
5601,277.5,685,442,243,0.431
5602,341.75,678,429,249,0.464
5603,202.5,603,404,199,0.589
5604,266.5,689,428,261,0.455
5605,44.75,3,3,0,1.991
5606,287.5,696,445,251,0.414
5607,204.5,683,443,240,0.431
5608,346,670,423,247,0.484
5609,220,724,457,267,0.362
5610,269.25,667,425,242,0.483
5611,262.5,649,437,212,0.477
5612,278.5,595,404,191,0.597
5613,279,637,425,212,0.513
5614,167.75,715,447,268,0.391
5615,26.75,0,0,0,2
5616,282,663,426,237,0.485
5617,10.75,0,0,0,2
5618,211.75,688,441,247,0.43
5619,215.5,716,446,270,0.392
5620,25,0,0,0,2
5621,305.5,730,449,281,0.372
5622,5.75,0,0,0,2
5623,234,714,455,259,0.376
5624,313.75,668,431,237,0.47
5625,36.75,2,1,1,1.996
5626,28.75,0,0,0,2
5627,266,664,440,224,0.456
5628,241.5,671,432,239,0.465
5629,277,651,431,220,0.487
5630,9.25,0,0,0,2
5631,238,662,426,236,0.486
5632,277.75,697,441,256,0.421
5633,261.75,636,410,226,0.544
5634,301,673,434,239,0.459
5635,234.5,718,453,265,0.376
5636,21,0,0,0,2
5637,217.75,699,452,247,0.397
5638,341,725,453,272,0.369
5639,217.75,676,445,231,0.434
5640,48,4,4,0,1.988
5641,24.75,0,0,0,2
5642,2.75,0,0,0,2
5643,34.25,4,3,1,1.99
5644,14,1,0,1,1.999
5645,289.5,655,419,236,0.507
5646,284.75,692,436,256,0.436
5647,260.75,654,427,227,0.492
5648,288.75,691,434,257,0.441
5649,282.25,690,448,242,0.414
5650,263.25,706,435,271,0.424
5651,290,662,436,226,0.466
5652,257.5,686,448,238,0.418
5653,239.25,695,450,245,0.405
5654,261.75,670,435,235,0.46
5655,32.5,4,4,0,1.988
5656,250.5,682,433,249,0.452
5657,296.25,699,442,257,0.417
5658,339,699,438,261,0.425
5659,34.5,0,0,0,2
5660,200,698,437,261,0.428
5661,229,690,432,258,0.446
5662,280.75,682,438,244,0.442
5663,30.5,2,1,1,1.996
5664,32.25,0,0,0,2
5665,222.75,675,439,236,0.447
5666,258.5,661,419,242,0.501
5667,216.75,710,450,260,0.39
5668,240.5,704,434,270,0.428
5669,245,687,453,234,0.407
5670,11,0,0,0,2
5671,24.75,0,0,0,2
5672,233,665,424,241,0.487
5673,274.75,637,410,227,0.543
5674,307.5,687,426,261,0.461
5675,31,1,1,0,1.997
5676,225.25,699,449,250,0.403
5677,232.25,684,438,246,0.44
5678,242.75,700,447,253,0.406
5679,272.5,669,436,233,0.459
5680,246.5,683,436,247,0.445
5681,9.75,0,0,0,2
5682,220.75,642,429,213,0.5
5683,276.75,683,426,257,0.465
5684,260,673,419,254,0.489
5685,279.75,674,425,249,0.476
5686,238.75,717,449,268,0.385
5687,315.25,669,427,242,0.477
5688,32,2,2,0,1.994
5689,61.5,9,6,3,1.979
5690,301,707,443,264,0.407
5691,62.25,3,2,1,1.993
5692,10.75,0,0,0,2
5693,21.25,1,1,0,1.997
5694,37.5,1,1,0,1.997
5695,317.25,648,421,227,0.51
5696,40.25,1,1,0,1.997
5697,278.25,693,437,256,0.433
5698,8,0,0,0,2
5699,291,697,443,254,0.417
5700,37,3,1,2,1.995
5701,23.75,0,0,0,2
5702,7.25,0,0,0,2
5703,16.25,0,0,0,2
5704,310.25,658,430,228,0.482
5705,295,718,452,266,0.378
5706,270.5,641,413,228,0.533
5707,18,0,0,0,2
5708,207,691,446,245,0.417
5709,231.75,732,450,282,0.368
5710,21.25,1,1,0,1.997
5711,26,0,0,0,2
5712,16.25,1,1,0,1.997
5713,328.5,676,435,241,0.454
5714,243,639,408,231,0.545
5715,321.25,741,450,291,0.359
5716,254.25,636,417,219,0.53
5717,266.25,710,444,266,0.402
5718,5.25,0,0,0,2
5719,262.5,691,434,257,0.441
5720,204.25,657,418,239,0.507
5721,232,684,444,240,0.428
5722,320.75,672,433,239,0.462
5723,9,0,0,0,2
5724,238.75,696,448,248,0.408
5725,271.25,694,435,259,0.436
5726,13,0,0,0,2
5727,11.5,0,0,0,2
5728,256,696,434,262,0.436
5729,16,1,1,0,1.997
5730,256.25,717,452,265,0.379
5731,216.5,680,427,253,0.466
5732,229.5,699,440,259,0.421
5733,271.75,732,455,277,0.358
5734,248.25,700,451,249,0.398
5735,229,644,423,221,0.51
5736,241.5,646,421,225,0.512
5737,297,654,429,225,0.488
5738,16.25,1,1,0,1.997
5739,20.25,0,0,0,2
5740,9.5,0,0,0,2
5741,11.75,0,0,0,2
5742,45.5,1,1,0,1.997
5743,21,0,0,0,2
5744,317,703,431,272,0.435
5745,260.5,694,425,269,0.456
5746,205.75,665,431,234,0.473
5747,253,686,439,247,0.436
5748,273.75,660,422,238,0.496
5749,10.5,0,0,0,2
5750,34.5,2,0,2,1.998
5751,11.75,0,0,0,2
5752,300,616,404,212,0.576
5753,20,2,2,0,1.994
5754,303,710,441,269,0.408
5755,223.25,654,428,226,0.49
5756,271.75,717,441,276,0.401
5757,30.75,1,0,1,1.999
5758,255.5,679,435,244,0.451
5759,21.25,0,0,0,2
5760,221.25,716,447,269,0.39
5761,107.5,12,6,6,1.976
5762,14.75,0,0,0,2
5763,268.25,709,439,270,0.413
5764,282.75,639,420,219,0.521
5765,256.25,716,443,273,0.398
5766,219.25,698,447,251,0.408
5767,339.75,649,419,230,0.513
5768,256,659,421,238,0.499
5769,291.25,675,423,252,0.479
5770,299.5,692,437,255,0.434
5771,300,680,447,233,0.426
5772,22.75,0,0,0,2
5773,21.75,0,0,0,2
5774,279.25,708,437,271,0.418
5775,247.5,687,449,238,0.415
5776,324,664,432,232,0.472
5777,272.25,704,447,257,0.402
5778,16,0,0,0,2
5779,263.25,642,413,229,0.532
5780,224.75,696,457,239,0.39
5781,239,709,455,254,0.381
5782,17.5,0,0,0,2
5783,253.25,679,438,241,0.445
5784,272.25,732,450,282,0.368
5785,412,660,427,233,0.486
5786,281.75,705,432,273,0.431
5787,292.75,683,436,247,0.445
5788,279.75,699,450,249,0.401
5789,315.25,681,442,239,0.435
5790,292,716,453,263,0.378
5791,317.5,723,456,267,0.365
5792,233.75,706,438,268,0.418
5793,275.75,709,444,265,0.403
5794,73.5,6,5,1,1.984
5795,25.25,1,1,0,1.997
5796,236.75,662,437,225,0.464
5797,260.5,717,442,275,0.399
5798,221.5,608,414,194,0.564
5799,206.25,692,442,250,0.424
5800,252.5,707,436,271,0.421
5801,23.75,3,2,1,1.993
5802,279.5,675,424,251,0.477
5803,261.75,729,454,275,0.363
5804,226.25,689,427,262,0.457
5805,328.25,700,433,267,0.434
5806,19.75,0,0,0,2
5807,239.5,681,446,235,0.427
5808,298.25,652,427,225,0.494
5809,248.25,698,435,263,0.432
5810,27.75,1,0,1,1.999
5811,12.25,0,0,0,2
5812,215.5,676,439,237,0.446
5813,299.75,656,430,226,0.484
5814,296.5,683,424,259,0.469
5815,12.5,0,0,0,2
5816,276,654,418,236,0.51
5817,27.5,4,4,0,1.988
5818,253.5,656,424,232,0.496
5819,27.5,1,1,0,1.997
5820,45,5,4,1,1.987
5821,279.5,661,432,229,0.475
5822,7.5,0,0,0,2
5823,241.5,720,454,266,0.372
5824,305.5,737,454,283,0.355
5825,260.25,688,431,257,0.45
5826,302.75,663,432,231,0.473
5827,310.75,636,422,214,0.52
5828,257.5,689,439,250,0.433
5829,253.75,707,442,265,0.409
5830,255.5,704,440,264,0.416
5831,52.5,2,2,0,1.994
5832,214.5,673,432,241,0.463
5833,233.5,690,440,250,0.43
5834,231.5,662,430,232,0.478
5835,259.25,702,448,254,0.402
5836,21.75,1,1,0,1.997
5837,292.5,666,422,244,0.49
5838,230.25,664,427,237,0.482
5839,6.5,0,0,0,2
5840,222,723,459,264,0.359
5841,290,658,428,230,0.486
5842,26,2,2,0,1.994
5843,6,0,0,0,2
5844,10.25,0,0,0,2
5845,264.5,651,427,224,0.495
5846,289,741,459,282,0.341
5847,261.25,668,417,251,0.498
5848,13.75,0,0,0,2
5849,267.5,678,443,235,0.436
5850,227.25,677,434,243,0.455
5851,18.75,0,0,0,2
5852,324.75,692,436,256,0.436
5853,263.75,708,447,261,0.398
5854,402.5,707,449,258,0.395
5855,259.25,685,433,252,0.449
5856,19.75,0,0,0,2
5857,285.75,691,438,253,0.433
5858,260.5,663,418,245,0.501
5859,47.75,7,4,3,1.985
5860,296,662,413,249,0.512
5861,268.75,702,442,260,0.414
5862,297.25,644,422,222,0.512
5863,260.25,696,433,263,0.438
5864,212.75,667,434,233,0.465
5865,255.25,699,432,267,0.437
5866,363.25,703,433,270,0.431
5867,212.75,715,446,269,0.393
5868,250.25,689,434,255,0.443
5869,275.5,698,440,258,0.422
5870,10,0,0,0,2
5871,254,685,439,246,0.437
5872,288.75,660,430,230,0.48
5873,263.5,649,417,232,0.517
5874,66.75,5,4,1,1.987
5875,268.75,662,429,233,0.48
5876,233.75,673,424,249,0.479
5877,246,653,429,224,0.489
5878,336.5,669,428,241,0.475
5879,226.5,697,445,252,0.413
5880,11,0,0,0,2
5881,337.5,668,434,234,0.464
5882,258.75,681,427,254,0.465
5883,336.5,688,443,245,0.426
5884,340,681,437,244,0.445
5885,335.25,672,431,241,0.466
5886,34.5,1,1,0,1.997
5887,263.25,669,436,233,0.459
5888,276.75,676,440,236,0.444
5889,238.75,706,449,257,0.396
5890,57.75,4,3,1,1.99
5891,282.25,699,440,259,0.421
5892,18.75,0,0,0,2
5893,14.5,0,0,0,2
5894,10.75,0,0,0,2
5895,238.75,724,446,278,0.384
5896,4.75,0,0,0,2
5897,18.25,2,2,0,1.994
5898,9.25,0,0,0,2
5899,278.5,687,436,251,0.441
5900,10.5,0,0,0,2
5901,7,0,0,0,2
5902,264.75,675,424,251,0.477
5903,275.5,637,424,213,0.515
5904,226,603,403,200,0.591
5905,255,667,446,221,0.441
5906,323.75,676,426,250,0.472
5907,248.25,687,434,253,0.445
5908,266.25,680,436,244,0.448
5909,275.5,636,413,223,0.538
5910,15.25,0,0,0,2
5911,329,661,422,239,0.495
5912,251.25,692,438,254,0.432
5913,5.75,0,0,0,2
5914,212.75,620,409,211,0.562
5915,276.25,705,442,263,0.411
5916,7.5,0,0,0,2
5917,25.25,1,1,0,1.997
5918,24.75,0,0,0,2
5919,269,637,418,219,0.527
5920,263,633,425,208,0.517
5921,245.75,701,451,250,0.397
5922,217.5,709,452,257,0.387
5923,19,0,0,0,2
5924,234.5,704,447,257,0.402
5925,280.25,708,425,283,0.442
5926,347.5,711,443,268,0.403
5927,336.5,640,419,221,0.522
5928,303.75,712,446,266,0.396
5929,13.75,1,1,0,1.997
5930,310,676,428,248,0.468
5931,14,0,0,0,2
5932,219.25,697,441,256,0.421
5933,223.5,679,435,244,0.451
5934,240.5,669,439,230,0.453
5935,383.25,668,418,250,0.496
5936,319.25,699,440,259,0.421
5937,11.5,0,0,0,2
5938,215.5,695,442,253,0.421
5939,19.25,0,0,0,2
5940,351.5,710,447,263,0.396
5941,261.5,675,434,241,0.457
5942,8.75,0,0,0,2
5943,311,659,417,242,0.507
5944,11,0,0,0,2
5945,10.75,0,0,0,2
5946,217.75,698,429,269,0.444
5947,23.75,1,1,0,1.997
5948,13.5,0,0,0,2
5949,10.25,0,0,0,2
5950,246.5,662,424,238,0.49
5951,20,0,0,0,2
5952,7.5,0,0,0,2
5953,229.75,711,440,271,0.409
5954,270.75,674,426,248,0.474
5955,12,0,0,0,2
5956,4.25,0,0,0,2
5957,11.5,0,0,0,2
5958,218.5,725,456,269,0.363
5959,260.75,674,420,254,0.486
5960,18,0,0,0,2
5961,301.75,719,451,268,0.379
5962,227.5,654,424,230,0.498
5963,233.75,683,431,252,0.455
5964,36,1,1,0,1.997
5965,238.5,700,441,259,0.418
5966,281.25,649,423,226,0.505
5967,310,660,430,230,0.48
5968,13,0,0,0,2
5969,241.25,695,446,249,0.413
5970,334.75,704,444,260,0.408
5971,4.75,0,0,0,2
5972,30,0,0,0,2
5973,213.5,721,448,273,0.383
5974,263.75,686,432,254,0.45
5975,24.5,0,0,0,2
5976,263.5,654,416,238,0.514
5977,198,633,413,220,0.541
5978,252.25,666,421,245,0.492
5979,358.75,718,446,272,0.39
5980,18.25,2,2,0,1.994
5981,222,670,434,236,0.462
5982,231.5,685,452,233,0.411
5983,10.75,0,0,0,2
5984,24.75,0,0,0,2
5985,290.75,659,422,237,0.497
5986,209.75,667,428,239,0.477
5987,324,636,413,223,0.538
5988,306.75,691,439,252,0.431
5989,256,691,444,247,0.421
5990,300.75,611,410,201,0.569
5991,293.75,693,447,246,0.413
5992,261,677,443,234,0.437
5993,251,705,438,267,0.419
5994,253.5,694,442,252,0.422
5995,234.5,671,431,240,0.467
5996,10.75,0,0,0,2
5997,346.25,657,418,239,0.507
5998,266.25,727,448,279,0.377
5999,12,0,0,0,2
6000,280.25,698,439,259,0.424
6001,273.5,659,423,236,0.495
6002,8,0,0,0,2
6003,21,1,1,0,1.997
6004,298.25,710,435,275,0.42
6005,250,701,445,256,0.409
6006,228,731,460,271,0.349
6007,222.5,719,452,267,0.377
6008,248.75,723,453,270,0.371
6009,264,687,436,251,0.441
6010,283.75,676,438,238,0.448
6011,17,0,0,0,2
6012,70,3,2,1,1.993
6013,234.75,686,428,258,0.458
6014,313,686,436,250,0.442
6015,278.5,617,414,203,0.555
6016,311.5,641,431,210,0.497
6017,204.75,677,433,244,0.457
6018,33.75,1,1,0,1.997
6019,303.5,702,433,269,0.432
6020,254.75,705,443,262,0.409
6021,17.25,0,0,0,2
6022,315.75,590,399,191,0.612
6023,278.75,680,434,246,0.452
6024,380.25,699,440,259,0.421
6025,280.5,694,449,245,0.408
6026,250,695,444,251,0.417
6027,224.5,666,431,235,0.472
6028,242.25,710,451,259,0.388
6029,215.5,633,422,211,0.523
6030,19.75,0,0,0,2
6031,252.25,717,452,265,0.379
6032,306,672,436,236,0.456
6033,219.5,611,411,200,0.567
6034,207,635,419,216,0.527
6035,224.25,645,426,219,0.503
6036,206.25,742,459,283,0.34
6037,22.25,1,1,0,1.997
6038,11.25,0,0,0,2
6039,305.75,664,428,236,0.48
6040,18.25,0,0,0,2
6041,48.25,1,1,0,1.997
6042,57.75,5,5,0,1.985
6043,296.75,714,442,272,0.402
6044,16.5,0,0,0,2
6045,238.5,699,452,247,0.397
6046,53,3,2,1,1.993
6047,251.5,700,443,257,0.414
6048,23.5,0,0,0,2
6049,10,0,0,0,2
6050,7.75,0,0,0,2
6051,21.75,0,0,0,2
6052,2,0,0,0,2
6053,299.75,653,423,230,0.501
6054,64.25,6,5,1,1.984
6055,213,675,425,250,0.475
6056,323.75,675,438,237,0.449
6057,279.75,686,434,252,0.446
6058,37.5,2,2,0,1.994
6059,7.25,0,0,0,2
6060,282.25,675,432,243,0.461
6061,288.75,701,440,261,0.419
6062,271.75,685,441,244,0.433
6063,237.5,673,428,245,0.471
6064,12,0,0,0,2
6065,80,4,3,1,1.99
6066,226.75,681,430,251,0.459
6067,217.25,691,436,255,0.437
6068,310.75,681,430,251,0.459
6069,257.75,720,450,270,0.38
6070,14,0,0,0,2
6071,346.5,717,452,265,0.379
6072,30.5,1,0,1,1.999
6073,265.25,661,424,237,0.491
6074,32,1,0,1,1.999
6075,288.25,663,421,242,0.495
6076,7,0,0,0,2
6077,260.5,656,418,238,0.508
6078,233.5,725,444,281,0.387
6079,210.5,712,448,264,0.392
6080,33,1,1,0,1.997
6081,319.5,670,427,243,0.476
6082,11.5,0,0,0,2
6083,32.75,2,0,2,1.998
6084,23.75,0,0,0,2
6085,43,2,2,0,1.994
6086,250.25,709,438,271,0.415
6087,21.25,0,0,0,2
6088,213.25,662,427,235,0.484
6089,33,2,1,1,1.996
6090,17.25,0,0,0,2
6091,229,656,429,227,0.486
6092,312.5,642,408,234,0.542
6093,282.75,646,429,217,0.496
6094,260,655,433,222,0.479
6095,246.25,649,415,234,0.521
6096,276.75,692,447,245,0.414
6097,252,689,429,260,0.453
6098,305.5,650,419,231,0.512
6099,270,643,420,223,0.517
6100,317.5,656,430,226,0.484
6101,21,1,1,0,1.997
6102,309.25,649,413,236,0.525
6103,4.5,0,0,0,2
6104,9.25,0,0,0,2
6105,10.5,0,0,0,2
6106,282.5,695,441,254,0.423
6107,222,729,451,278,0.369
6108,238.75,703,452,251,0.393
6109,227.25,654,412,242,0.522
6110,247.75,733,454,279,0.359
6111,13,0,0,0,2
6112,17.75,0,0,0,2
6113,221.5,671,438,233,0.453
6114,269,726,454,272,0.366
6115,236,694,443,251,0.42
6116,253.5,638,408,230,0.546
6117,332.25,682,424,258,0.47
6118,11.25,0,0,0,2
6119,248.75,622,400,222,0.578
6120,245,702,437,265,0.424
6121,216.75,664,422,242,0.492
6122,19.75,2,1,1,1.996
6123,15.25,0,0,0,2
6124,333.5,690,439,251,0.432
6125,289.5,639,413,226,0.535
6126,247,677,437,240,0.449
6127,262.75,674,431,243,0.464
6128,294.75,705,444,261,0.407
6129,256,621,412,209,0.555
6130,345.5,666,428,238,0.478
6131,34,3,1,2,1.995
6132,243,650,418,232,0.514
6133,323,670,435,235,0.46
6134,282.75,677,445,232,0.433
6135,286.25,675,430,245,0.465
6136,38.25,1,1,0,1.997
6137,22.75,0,0,0,2
6138,11,0,0,0,2
6139,26.75,0,0,0,2
6140,276,672,424,248,0.48
6141,313,713,440,273,0.407
6142,231.5,692,442,250,0.424
6143,232,747,450,297,0.353
6144,7.5,0,0,0,2
6145,30.5,1,1,0,1.997
6146,281.25,649,426,223,0.499
6147,281.5,711,443,268,0.403
6148,16.25,0,0,0,2
6149,7,0,0,0,2
6150,21.5,1,0,1,1.999
6151,243.75,619,396,223,0.589
6152,240.5,676,437,239,0.45
6153,41,3,2,1,1.993
6154,215.75,680,436,244,0.448
6155,221,724,443,281,0.39
6156,25,1,0,1,1.999
6157,285.25,641,419,222,0.521
6158,17.75,0,0,0,2
6159,209.25,678,433,245,0.456
6160,4.5,0,0,0,2
6161,294.5,712,443,269,0.402
6162,261.5,662,433,229,0.472
6163,12.25,0,0,0,2
6164,220.75,739,457,282,0.347
6165,261.25,681,444,237,0.431
6166,4,0,0,0,2
6167,264,687,437,250,0.439
6168,242,696,436,260,0.432
6169,47.75,0,0,0,2
6170,309,667,436,231,0.461
6171,249.75,659,431,228,0.479
6172,271.75,642,419,223,0.52
6173,29.25,0,0,0,2
6174,245.75,702,442,260,0.414
6175,20,0,0,0,2
6176,5.75,0,0,0,2
6177,277.25,671,422,249,0.485
6178,37.5,1,1,0,1.997
6179,56.5,1,0,1,1.999
6180,240,670,430,240,0.47
6181,232.75,665,431,234,0.473
6182,281.25,641,412,229,0.535
6183,13,0,0,0,2
6184,43.75,1,1,0,1.997
6185,294.5,693,444,249,0.419
6186,293.5,645,414,231,0.527
6187,259.25,654,431,223,0.484
6188,243.25,650,430,220,0.49
6189,15.25,0,0,0,2
6190,220,662,428,234,0.482
6191,239.75,663,432,231,0.473
6192,252.5,690,430,260,0.45
6193,332.75,677,439,238,0.445
6194,281,739,450,289,0.361
6195,203.5,669,442,227,0.447
6196,210,718,446,272,0.39
6197,250.75,648,433,215,0.486
6198,249,654,437,217,0.472
6199,260,679,439,240,0.443
6200,243.75,727,451,276,0.371
6201,263.75,681,445,236,0.429
6202,30.25,1,0,1,1.999
6203,12.5,0,0,0,2
6204,6,0,0,0,2
6205,232.25,696,436,260,0.432
6206,288.75,677,436,241,0.451
6207,11.25,0,0,0,2
6208,204.25,692,440,252,0.428
6209,242.75,691,445,246,0.419
6210,246.5,714,446,268,0.394
6211,214.5,672,428,244,0.472
6212,287.25,682,445,237,0.428
6213,209,681,432,249,0.455
6214,291.75,678,441,237,0.44
6215,245,674,428,246,0.47
6216,303.75,709,440,269,0.411
6217,287.25,709,446,263,0.399
6218,19.75,1,1,0,1.997
6219,303,704,436,268,0.424
6220,251,693,433,260,0.441
6221,300.5,662,435,227,0.468
6222,240.5,700,441,259,0.418
6223,353.75,673,430,243,0.467
6224,8.5,0,0,0,2
6225,289.5,713,446,267,0.395
6226,206.5,740,456,284,0.348
6227,257.75,685,427,258,0.461
6228,33.5,3,1,2,1.995
6229,260,664,435,229,0.466
6230,291.25,740,458,282,0.344
6231,4.25,0,0,0,2
6232,284.75,688,432,256,0.448
6233,246.75,630,426,204,0.518
6234,293.5,690,443,247,0.424
6235,203.5,685,450,235,0.415
6236,20.75,0,0,0,2
6237,19.75,0,0,0,2
6238,341.5,651,416,235,0.517
6239,23.5,0,0,0,2
6240,253.75,685,435,250,0.445
6241,308,695,438,257,0.429
6242,253,659,429,230,0.483
6243,307.25,707,453,254,0.387
6244,51,5,5,0,1.985
6245,15.5,0,0,0,2
6246,7,0,0,0,2
6247,335.25,695,428,267,0.449
6248,219.75,709,444,265,0.403
6249,257.75,634,411,223,0.544
6250,32.5,1,1,0,1.997
6251,21.75,1,0,1,1.999
6252,54.5,2,0,2,1.998
6253,326.25,659,420,239,0.501
6254,27,0,0,0,2
6255,234.5,674,448,226,0.43
6256,215.25,717,446,271,0.391
6257,263.25,669,428,241,0.475
6258,265.25,730,445,285,0.38
6259,275.5,674,427,247,0.472
6260,233.25,688,439,249,0.434
6261,25.75,1,1,0,1.997
6262,11.5,1,1,0,1.997
6263,239,715,449,266,0.387
6264,322.5,708,451,257,0.39
6265,260.25,688,437,251,0.438
6266,220.5,696,436,260,0.432
6267,247.75,693,435,258,0.437
6268,282.75,706,453,253,0.388
6269,287.25,702,452,250,0.394
6270,3.5,0,0,0,2
6271,261,732,444,288,0.38
6272,6,0,0,0,2
6273,390.25,685,437,248,0.441
6274,7.25,0,0,0,2
6275,14.25,0,0,0,2
6276,31.75,1,1,0,1.997
6277,231,687,450,237,0.413
6278,335.25,675,423,252,0.479
6279,3.5,0,0,0,2
6280,10.25,0,0,0,2
6281,6,0,0,0,2
6282,273.5,686,427,259,0.46
6283,323.5,710,457,253,0.376
6284,196,677,431,246,0.461
6285,298.5,679,437,242,0.447
6286,252.75,735,465,270,0.335
6287,35,2,2,0,1.994
6288,10,0,0,0,2
6289,12.25,0,0,0,2
6290,284.5,640,413,227,0.534
6291,36.5,1,0,1,1.999
6292,15.5,0,0,0,2
6293,274,707,445,262,0.403
6294,26.5,2,2,0,1.994
6295,302.75,691,444,247,0.421
6296,277.75,732,447,285,0.374
6297,20,0,0,0,2
6298,256.5,661,425,236,0.489
6299,12,0,0,0,2
6300,254.25,665,424,241,0.487
6301,268.75,686,438,248,0.438
6302,9.5,0,0,0,2
6303,252,648,434,214,0.484
6304,303.25,661,426,235,0.487
6305,4,0,0,0,2
6306,28.75,0,0,0,2
6307,21.25,1,0,1,1.999
6308,246,713,440,273,0.407
6309,242.25,660,429,231,0.482
6310,188,643,420,223,0.517
6311,12.25,0,0,0,2
6312,10.5,0,0,0,2
6313,302.5,686,440,246,0.434
6314,302.5,655,429,226,0.487
6315,245,684,439,245,0.438
6316,249.25,611,407,204,0.575
6317,343.5,685,444,241,0.427
6318,11,0,0,0,2
6319,255,676,443,233,0.438
6320,242.75,694,431,263,0.444
6321,322.75,671,425,246,0.479
6322,285.75,670,437,233,0.456
6323,6.5,0,0,0,2
6324,35.5,3,2,1,1.993
6325,228.75,725,459,266,0.357
6326,274.5,652,421,231,0.506
6327,240.25,733,453,280,0.361
6328,243,672,422,250,0.484
6329,274.25,708,440,268,0.412
6330,246.75,721,442,279,0.395
6331,283,711,443,268,0.403
6332,278.75,679,441,238,0.439
6333,90,7,6,1,1.981
6334,235.5,667,436,231,0.461
6335,203.75,703,441,262,0.415
6336,237.5,687,430,257,0.453
6337,13,0,0,0,2
6338,230,662,429,233,0.48
6339,229.5,714,448,266,0.39
6340,307.5,679,440,239,0.441
6341,260,715,443,272,0.399
6342,27.75,2,2,0,1.994
6343,286.5,711,441,270,0.407
6344,17.75,0,0,0,2
6345,38.25,0,0,0,2
6346,320.75,631,415,216,0.539
6347,334.75,696,446,250,0.412
6348,255.25,725,450,275,0.375
6349,206.75,711,448,263,0.393
6350,261.75,672,413,259,0.502
6351,226.25,708,446,262,0.4
6352,46,3,3,0,1.991
6353,299,720,436,284,0.408
6354,307.75,693,446,247,0.415
6355,19.75,0,0,0,2
6356,18,1,1,0,1.997
6357,54.5,4,2,2,1.992
6358,9,0,0,0,2
6359,233.5,737,456,281,0.351
6360,31,0,0,0,2
6361,28.5,1,0,1,1.999
6362,270.75,688,436,252,0.44
6363,18.5,0,0,0,2
6364,331,698,443,255,0.416
6365,275.5,687,438,249,0.437
6366,227.75,692,449,243,0.41
6367,26.25,0,0,0,2
6368,200.25,690,443,247,0.424
6369,11.5,0,0,0,2
6370,42.5,4,1,3,1.994
6371,287.25,628,424,204,0.524
6372,262.75,671,437,234,0.455
6373,239.75,693,445,248,0.417
6374,256,678,438,240,0.446
6375,321,734,454,280,0.358
6376,218.5,708,445,263,0.402
6377,252.75,680,433,247,0.454
6378,246.25,721,448,273,0.383
6379,237.75,672,426,246,0.476
6380,222.5,661,420,241,0.499
6381,270.75,625,412,213,0.551
6382,283.5,750,456,294,0.338
6383,349,698,449,249,0.404
6384,6.75,0,0,0,2
6385,304,633,424,209,0.519
6386,225.5,667,441,226,0.451
6387,260.75,686,438,248,0.438
6388,232.25,671,432,239,0.465
6389,37.5,3,2,1,1.993
6390,18.75,0,0,0,2
6391,229.5,644,426,218,0.504
6392,301.75,640,418,222,0.524
6393,237.75,731,458,273,0.353
6394,280.75,703,446,257,0.405
6395,207,687,440,247,0.433
6396,16.5,0,0,0,2
6397,17.25,0,0,0,2
6398,17.5,0,0,0,2
6399,17.75,2,0,2,1.998
6400,283.75,688,444,244,0.424
6401,318.25,692,450,242,0.408
6402,246,697,444,253,0.415
6403,365.25,711,449,262,0.391
6404,273,711,439,272,0.411
6405,176,710,451,259,0.388
6406,298.25,679,428,251,0.465
6407,319.75,715,435,280,0.415
6408,293,689,448,241,0.415
6409,27.25,1,1,0,1.997
6410,12,0,0,0,2
6411,289.25,700,444,256,0.412
6412,234.75,683,442,241,0.433
6413,261.25,673,425,248,0.477
6414,29.25,1,1,0,1.997
6415,275.25,702,436,266,0.426
6416,292.5,718,449,269,0.384
6417,304.5,673,431,242,0.465
6418,223.5,711,444,267,0.401
6419,280.25,668,431,237,0.47
6420,274,707,457,250,0.379
6421,237,688,435,253,0.442
6422,278.5,659,431,228,0.479
6423,25.5,0,0,0,2
6424,222,674,434,240,0.458
6425,38,2,2,0,1.994
6426,286,710,435,275,0.42
6427,294.5,646,417,229,0.52
6428,305,624,419,205,0.538
6429,311.75,614,418,196,0.55
6430,243.5,688,442,246,0.428
6431,14,0,0,0,2
6432,260,699,444,255,0.413
6433,231.25,698,444,254,0.414
6434,9.25,0,0,0,2
6435,6.75,0,0,0,2
6436,18.25,0,0,0,2
6437,8.25,0,0,0,2
6438,222.25,679,442,237,0.437
6439,251,655,419,236,0.507
6440,264.5,718,454,264,0.374
6441,238.75,659,427,232,0.487
6442,72,8,8,0,1.976
6443,224.75,643,425,218,0.507
6444,300,684,433,251,0.45
6445,263.75,683,438,245,0.441
6446,225,689,434,255,0.443
6447,219.25,693,443,250,0.421
6448,290.25,682,439,243,0.44
6449,241.25,651,422,229,0.505
6450,232.25,644,412,232,0.532
6451,9.25,0,0,0,2
6452,241.75,756,468,288,0.308
6453,10.75,0,0,0,2
6454,9.5,0,0,0,2
6455,294.75,694,452,242,0.402
6456,13.75,0,0,0,2
6457,241,700,450,250,0.4
6458,13.5,1,1,0,1.997
6459,9,0,0,0,2
6460,25,1,1,0,1.997
6461,12.75,0,0,0,2
6462,12.25,0,0,0,2
6463,312.75,694,435,259,0.436
6464,11,0,0,0,2
6465,235.25,684,427,257,0.462
6466,233,684,438,246,0.44
6467,415,698,432,266,0.438
6468,326.75,696,444,252,0.416
6469,230.5,637,423,214,0.517
6470,312,695,437,258,0.431
6471,290.75,642,415,227,0.528
6472,287.25,693,439,254,0.429
6473,16,0,0,0,2
6474,265.25,647,425,222,0.503
6475,8,0,0,0,2
6476,258,708,457,251,0.378
6477,10.25,0,0,0,2
6478,256,661,436,225,0.467
6479,253.25,690,431,259,0.448
6480,20.75,0,0,0,2
6481,21,1,1,0,1.997
6482,280.5,678,424,254,0.474
6483,295.25,711,448,263,0.393
6484,7,0,0,0,2
6485,296.75,692,437,255,0.434
6486,318.75,677,429,248,0.465
6487,226.25,680,427,253,0.466
6488,257.5,687,437,250,0.439
6489,222.25,732,454,278,0.36
6490,235.25,698,452,246,0.398
6491,71.5,8,4,4,1.984
6492,276.75,719,455,264,0.371
6493,20.75,0,0,0,2
6494,288.75,719,445,274,0.391
6495,45.75,3,2,1,1.993
6496,249.75,725,465,260,0.345
6497,240.5,726,442,284,0.39
6498,7.75,0,0,0,2
6499,86.5,5,4,1,1.987
6500,38,1,1,0,1.997
6501,7,0,0,0,2
6502,264.5,705,461,244,0.373
6503,267.25,713,448,265,0.391
6504,222.5,689,440,249,0.431
6505,7.5,0,0,0,2
6506,252.5,627,416,211,0.541
6507,244.25,691,448,243,0.413
6508,234.5,644,425,219,0.506
6509,11,0,0,0,2
6510,359.5,658,433,225,0.476
6511,255,692,420,272,0.468
6512,251.75,655,427,228,0.491
6513,280,699,434,265,0.433
6514,223.75,692,435,257,0.438
6515,14.25,0,0,0,2
6516,257.75,660,426,234,0.488
6517,242,722,445,277,0.388
6518,16.5,1,1,0,1.997
6519,286.5,677,438,239,0.447
6520,258.75,659,424,235,0.493
6521,262.25,662,435,227,0.468
6522,16.25,0,0,0,2
6523,35,0,0,0,2
6524,299,633,416,217,0.535
6525,238.5,679,439,240,0.443
6526,58,7,3,4,1.987
6527,218.75,696,440,256,0.424
6528,272.75,680,447,233,0.426
6529,197.75,660,436,224,0.468
6530,277.25,708,443,265,0.406
6531,7.75,0,0,0,2
6532,301,708,443,265,0.406
6533,258.25,727,451,276,0.371
6534,249.25,731,450,281,0.369
6535,213,733,451,282,0.365
6536,332.75,711,446,265,0.397
6537,297.25,643,409,234,0.539
6538,22.25,2,1,1,1.996
6539,16.25,0,0,0,2
6540,257.75,673,426,247,0.475
6541,237.25,665,446,219,0.443
6542,242,652,412,240,0.524
6543,285.75,666,430,236,0.474
6544,323.25,681,441,240,0.437
6545,11.25,0,0,0,2
6546,6.75,0,0,0,2
6547,252,667,419,248,0.495
6548,270.75,750,461,289,0.328
6549,231.75,709,453,256,0.385
6550,218.5,652,424,228,0.5
6551,8.5,0,0,0,2
6552,235,684,434,250,0.448
6553,275.5,693,438,255,0.431
6554,283.25,710,446,264,0.398
6555,254.5,669,434,235,0.463
6556,219.75,656,422,234,0.5
6557,274.75,648,426,222,0.5
6558,348.5,711,436,275,0.417
6559,6.25,0,0,0,2
6560,28,0,0,0,2
6561,298.25,656,421,235,0.502
6562,306.75,637,415,222,0.533
6563,279,724,447,277,0.382
6564,5.5,0,0,0,2
6565,7.5,0,0,0,2
6566,263.5,723,448,275,0.381
6567,256,699,443,256,0.415
6568,7.25,0,0,0,2
6569,14.75,0,0,0,2
6570,288.75,648,420,228,0.512
6571,12.5,0,0,0,2
6572,240.25,687,440,247,0.433
6573,38,4,4,0,1.988
6574,235,705,448,257,0.399
6575,245.5,678,436,242,0.45
6576,264,658,425,233,0.492
6577,244,692,447,245,0.414
6578,258,639,410,229,0.541
6579,323,650,424,226,0.502
6580,298,703,452,251,0.393
6581,23.75,2,2,0,1.994
6582,17.75,0,0,0,2
6583,242.25,710,446,264,0.398
6584,19,0,0,0,2
6585,287.75,620,416,204,0.548
6586,226.75,657,428,229,0.487
6587,16.5,0,0,0,2
6588,255.25,694,439,255,0.428
6589,278.75,663,424,239,0.489
6590,232,669,430,239,0.471
6591,378.25,619,405,214,0.571
6592,247,725,455,270,0.365
6593,26.5,1,1,0,1.997
6594,18.75,0,0,0,2
6595,332.5,700,435,265,0.43
6596,319.5,652,433,219,0.482
6597,243.75,682,437,245,0.444
6598,20.5,1,1,0,1.997
6599,236,681,424,257,0.471
6600,248,668,427,241,0.478
6601,232.5,623,414,209,0.549
6602,14.25,0,0,0,2
6603,289,653,417,236,0.513
6604,202.25,675,444,231,0.437
6605,225,670,433,237,0.464
6606,285.75,654,420,234,0.506
6607,221,687,444,243,0.425
6608,272.5,672,427,245,0.474
6609,32,3,3,0,1.991
6610,7.5,0,0,0,2
6611,295,631,425,206,0.519
6612,9.25,0,0,0,2
6613,14.75,0,0,0,2
6614,248.5,752,464,288,0.32
6615,268.25,627,408,219,0.557
6616,6.25,0,0,0,2
6617,290.75,684,439,245,0.438
6618,271.75,727,452,275,0.369
6619,22,1,1,0,1.997
6620,243.5,655,435,220,0.475
6621,204,675,434,241,0.457
6622,251.5,706,450,256,0.394
6623,338,641,417,224,0.525
6624,47.75,2,2,0,1.994
6625,244,681,430,251,0.459
6626,249.25,658,420,238,0.502
6627,14,0,0,0,2
6628,15,0,0,0,2
6629,45.75,2,2,0,1.994
6630,9.75,0,0,0,2
6631,494.25,658,426,232,0.49
6632,273.75,613,400,213,0.587
6633,26,0,0,0,2
6634,270.5,691,435,256,0.439
6635,260,656,421,235,0.502
6636,252.25,657,426,231,0.491
6637,14.25,0,0,0,2
6638,12.75,0,0,0,2
6639,273.25,661,428,233,0.483
6640,12.75,0,0,0,2
6641,14.5,0,0,0,2
6642,19.5,0,0,0,2
6643,24,1,1,0,1.997
6644,204.25,670,426,244,0.478
6645,252.25,676,426,250,0.472
6646,6,0,0,0,2
6647,244.5,657,428,229,0.487
6648,15.75,0,0,0,2
6649,286,653,417,236,0.513
6650,283.5,694,447,247,0.412
6651,277.5,681,428,253,0.463
6652,12,0,0,0,2
6653,221.25,649,423,226,0.505
6654,273.25,680,429,251,0.462
6655,11.5,0,0,0,2
6656,13.25,0,0,0,2
6657,249.5,628,415,213,0.542
6658,289.75,674,443,231,0.44
6659,214.25,702,440,262,0.418
6660,46.5,0,0,0,2
6661,374.25,708,450,258,0.392
6662,282.5,676,428,248,0.468
6663,279.5,707,455,252,0.383
6664,261.75,708,438,270,0.416
6665,315.5,682,434,248,0.45
6666,254.75,665,436,229,0.463
6667,211.25,686,431,255,0.452
6668,261,640,426,214,0.508
6669,225.5,713,433,280,0.421
6670,254.75,706,443,263,0.408
6671,278,649,424,225,0.503
6672,234.75,681,437,244,0.445
6673,349,613,405,208,0.577
6674,59.5,5,5,0,1.985
6675,231.25,677,431,246,0.461
6676,264.5,661,438,223,0.463
6677,259.25,669,423,246,0.485
6678,37.75,1,0,1,1.999
6679,12.5,0,0,0,2
6680,285.75,687,431,256,0.451
6681,286,731,456,275,0.357
6682,9.75,0,0,0,2
6683,390.5,642,425,217,0.508
6684,5.75,0,0,0,2
6685,304.25,694,432,262,0.442
6686,292.25,672,436,236,0.456
6687,283.75,702,441,261,0.416
6688,248.75,692,437,255,0.434
6689,60.5,7,7,0,1.979
6690,269.75,673,439,234,0.449
6691,252.75,634,411,223,0.544
6692,219,696,447,249,0.41
6693,29.25,2,2,0,1.994
6694,8.25,0,0,0,2
6695,276.75,690,436,254,0.438
6696,14,0,0,0,2
6697,51.25,7,5,2,1.983
6698,195,716,450,266,0.384
6699,18.25,0,0,0,2
6700,38,1,1,0,1.997
6701,31.5,1,1,0,1.997
6702,14.25,0,0,0,2
6703,281.25,689,437,252,0.437
6704,5,0,0,0,2
6705,255.5,708,450,258,0.392
6706,15.25,0,0,0,2
6707,19.25,0,0,0,2
6708,16.5,0,0,0,2
6709,286.75,662,425,237,0.488
6710,276,683,443,240,0.431
6711,321.75,724,454,270,0.368
6712,290.75,617,412,205,0.559
6713,297,671,432,239,0.465
6714,7.25,0,0,0,2
6715,206.25,696,441,255,0.422
6716,32.5,1,1,0,1.997
6717,179.5,696,439,257,0.426
6718,16,0,0,0,2
6719,63,6,3,3,1.988
6720,223.5,714,451,263,0.384
6721,327.25,723,449,274,0.379
6722,253.75,694,445,249,0.416
6723,240,696,437,259,0.43
6724,286.25,667,427,240,0.479
6725,56.75,8,5,3,1.982
6726,16,0,0,0,2
6727,245.75,703,439,264,0.419
6728,12.75,0,0,0,2
6729,78.75,7,6,1,1.981
6730,8.5,0,0,0,2
6731,271.75,739,443,296,0.375
6732,20.5,1,1,0,1.997
6733,292,689,429,260,0.453
6734,312,710,450,260,0.39
6735,297.5,668,430,238,0.472
6736,17.5,0,0,0,2
6737,349,666,430,236,0.474
6738,246.75,700,448,252,0.404
6739,249.75,655,429,226,0.487
6740,231,694,441,253,0.424
6741,266.5,670,431,239,0.468
6742,274.25,675,431,244,0.463
6743,40.25,4,3,1,1.99
6744,239.25,692,438,254,0.432
6745,297.5,675,434,241,0.457
6746,435,699,443,256,0.415
6747,262,686,436,250,0.442
6748,8.25,0,0,0,2
6749,240.75,672,428,244,0.472
6750,295.25,656,425,231,0.494
6751,281.5,688,440,248,0.432
6752,252.5,671,431,240,0.467
6753,191.25,721,458,263,0.363
6754,16,0,0,0,2
6755,239,675,437,238,0.451
6756,47.75,3,3,0,1.991
6757,12,0,0,0,2
6758,25.5,1,1,0,1.997
6759,300.25,703,448,255,0.401
6760,202.75,723,455,268,0.367
6761,231,701,447,254,0.405
6762,256,691,445,246,0.419
6763,273,684,434,250,0.448
6764,271.25,678,434,244,0.454
6765,267,665,421,244,0.493
6766,302.5,700,443,257,0.414
6767,271.25,672,428,244,0.472
6768,14.25,0,0,0,2
6769,246.5,687,445,242,0.423
6770,253.5,716,444,272,0.396
6771,29.75,3,0,3,1.997
6772,34.5,3,2,1,1.993
6773,227,694,432,262,0.442
6774,261.25,691,446,245,0.417
6775,283.75,652,425,227,0.498
6776,5,0,0,0,2
6777,290,657,415,242,0.513
6778,3.5,0,0,0,2
6779,204.75,686,440,246,0.434
6780,268.5,680,440,240,0.44
6781,280,675,431,244,0.463
6782,243.75,708,445,263,0.402
6783,45.75,3,2,1,1.993
6784,284.75,686,439,247,0.436
6785,10.25,0,0,0,2
6786,283,700,442,258,0.416
6787,5.25,0,0,0,2
6788,290.25,661,423,238,0.493
6789,348.5,730,448,282,0.374
6790,12.5,0,0,0,2
6791,8.75,0,0,0,2
6792,254.25,682,433,249,0.452
6793,261.5,614,411,203,0.564
6794,340.25,698,443,255,0.416
6795,6,0,0,0,2
6796,219.5,694,443,251,0.42
6797,286.5,684,437,247,0.442
6798,234.75,749,459,290,0.333
6799,281.75,679,429,250,0.463
6800,238.25,665,419,246,0.497
6801,244,678,440,238,0.442
6802,7.75,0,0,0,2
6803,16.75,0,0,0,2
6804,23,0,0,0,2
6805,245.5,685,428,257,0.459
6806,230,673,436,237,0.455
6807,381.75,676,437,239,0.45
6808,214.75,673,439,234,0.449
6809,286.25,692,437,255,0.434
6810,206.25,666,431,235,0.472
6811,241.25,708,444,264,0.404
6812,283.75,674,436,238,0.454
6813,313.5,689,417,272,0.477
6814,292.25,673,431,242,0.465
6815,231.5,652,419,233,0.51
6816,19.5,0,0,0,2
6817,236.75,687,439,248,0.435
6818,292.75,622,410,212,0.558
6819,228,671,431,240,0.467
6820,242.25,676,436,240,0.452
6821,41,1,0,1,1.999
6822,265,721,453,268,0.373
6823,15.5,1,1,0,1.997
6824,266.75,682,435,247,0.448
6825,31.75,3,2,1,1.993
6826,5,0,0,0,2
6827,233.25,725,463,262,0.349
6828,13,0,0,0,2
6829,274.75,688,442,246,0.428
6830,340,672,441,231,0.446
6831,44.75,4,3,1,1.99
6832,264.5,652,431,221,0.486
6833,255.75,649,413,236,0.525
6834,295,657,425,232,0.493
6835,218,671,428,243,0.473
6836,260.25,696,431,265,0.442
6837,11.25,0,0,0,2
6838,37.25,4,2,2,1.992
6839,299.5,689,430,259,0.451
6840,23.5,0,0,0,2
6841,55.5,3,2,1,1.993
6842,266.25,703,441,262,0.415
6843,291,703,454,249,0.389
6844,328.75,654,418,236,0.51
6845,257.5,707,443,264,0.407
6846,264,696,432,264,0.44
6847,249.5,719,451,268,0.379
6848,236,687,438,249,0.437
6849,291.5,725,444,281,0.387
6850,353.5,689,430,259,0.451
6851,13.25,0,0,0,2
6852,215,683,434,249,0.449
6853,236,670,431,239,0.468
6854,209.5,695,439,256,0.427
6855,246,704,443,261,0.41
6856,285.25,680,436,244,0.448
6857,28.75,1,1,0,1.997
6858,20.75,0,0,0,2
6859,365.75,682,453,229,0.412
6860,296.5,693,458,235,0.391
6861,279,692,433,259,0.442
6862,241.75,685,433,252,0.449
6863,256.5,722,449,273,0.38
6864,256,680,442,238,0.436
6865,325.25,635,425,210,0.515
6866,270.25,712,441,271,0.406
6867,286.5,710,446,264,0.398
6868,323.75,667,429,238,0.475
6869,248,666,425,241,0.484
6870,259.75,624,410,214,0.556
6871,277,670,428,242,0.474
6872,250.75,668,432,236,0.468
6873,222,692,433,259,0.442
6874,11.25,0,0,0,2
6875,302.5,664,422,242,0.492
6876,263.75,698,443,255,0.416
6877,236.25,676,428,248,0.468
6878,293.5,684,432,252,0.452
6879,281.75,668,422,246,0.488
6880,65.25,7,7,0,1.979
6881,330.75,713,447,266,0.393
6882,6.75,0,0,0,2
6883,267,722,450,272,0.378
6884,261.5,714,447,267,0.392
6885,26.25,1,0,1,1.999
6886,21.25,0,0,0,2
6887,306.75,644,420,224,0.516
6888,286.25,656,419,237,0.506
6889,295.5,677,440,237,0.443
6890,19.5,0,0,0,2
6891,22.5,2,1,1,1.996
6892,23.25,0,0,0,2
6893,276.75,674,425,249,0.476
6894,262.25,667,438,229,0.457
6895,236.5,702,435,267,0.428
6896,264,654,427,227,0.492
6897,6.75,0,0,0,2
6898,294,692,434,258,0.44
6899,265.5,640,425,215,0.51
6900,47,1,1,0,1.997
6901,40.25,3,3,0,1.991
6902,57,3,2,1,1.993
6903,234.5,701,448,253,0.403
6904,280.5,668,432,236,0.468
6905,241,676,435,241,0.454
6906,223,704,442,262,0.412
6907,269.75,695,449,246,0.407
6908,249.5,716,454,262,0.376
6909,237.75,708,441,267,0.41
6910,20.75,0,0,0,2
6911,15.25,1,1,0,1.997
6912,244,731,453,278,0.363
6913,225,685,436,249,0.443
6914,8.75,0,0,0,2
6915,43,1,1,0,1.997
6916,282.5,661,421,240,0.497
6917,261.75,648,428,220,0.496
6918,11.75,0,0,0,2
6919,9,0,0,0,2
6920,54.75,3,1,2,1.995
6921,17.5,0,0,0,2
6922,355.5,699,439,260,0.423
6923,322.5,712,441,271,0.406
6924,226.5,663,427,236,0.483
6925,290,689,442,247,0.427
6926,8.75,0,0,0,2
6927,235,642,412,230,0.534
6928,5.5,0,0,0,2
6929,224.25,699,449,250,0.403
6930,221.25,683,433,250,0.451
6931,230.5,688,431,257,0.45
6932,260,665,427,238,0.481
6933,230.25,720,441,279,0.398
6934,38,2,1,1,1.996
6935,332,692,434,258,0.44
6936,184.5,593,400,193,0.607
6937,243.5,711,446,265,0.397
6938,309.5,630,400,230,0.57
6939,324.25,705,444,261,0.407
6940,9.5,0,0,0,2
6941,274.5,695,435,260,0.435
6942,289.75,678,437,241,0.448
6943,5.25,0,0,0,2
6944,313,721,448,273,0.383
6945,19.5,1,1,0,1.997
6946,297.25,690,439,251,0.432
6947,245,634,421,213,0.524
6948,22.75,0,0,0,2
6949,235,646,433,213,0.488
6950,222.75,655,413,242,0.519
6951,232,652,420,232,0.508
6952,10,0,0,0,2
6953,279.25,719,448,271,0.385
6954,7.5,0,0,0,2
6955,325.25,701,435,266,0.429
6956,213,691,442,249,0.425
6957,315,647,419,228,0.515
6958,259,686,441,245,0.432
6959,17.25,0,0,0,2
6960,297,681,446,235,0.427
6961,267,674,429,245,0.468
6962,228.25,622,417,205,0.544
6963,291,701,438,263,0.423
6964,247.75,700,444,256,0.412
6965,17.25,0,0,0,2
6966,256,699,451,248,0.399
6967,282,660,426,234,0.488
6968,315,714,447,267,0.392
6969,326.5,652,435,217,0.478
6970,24,1,1,0,1.997
6971,197.5,705,442,263,0.411
6972,230.75,693,441,252,0.425
6973,57.25,3,2,1,1.993
6974,288.5,651,413,238,0.523
6975,239.25,647,418,229,0.517
6976,269.5,728,461,267,0.35
6977,261.5,678,428,250,0.466
6978,275.5,679,430,249,0.461
6979,205.5,731,465,266,0.339
6980,296.75,647,437,210,0.479
6981,252.25,676,434,242,0.456
6982,310.5,714,441,273,0.404
6983,38,4,1,3,1.994
6984,19.25,0,0,0,2
6985,194,695,442,253,0.421
6986,264.75,695,445,250,0.415
6987,322.25,667,431,236,0.471
6988,290.5,674,451,223,0.424
6989,28.75,1,0,1,1.999
6990,12.25,0,0,0,2
6991,82.5,12,9,3,1.97
6992,16.5,0,0,0,2
6993,254,718,450,268,0.382
6994,259,677,446,231,0.431
6995,4.75,0,0,0,2
6996,249,655,428,227,0.489
6997,7,0,0,0,2
6998,257.5,699,437,262,0.427
6999,257.25,642,425,217,0.508
7000,275.75,691,439,252,0.431
7001,266.5,701,440,261,0.419
7002,9,0,0,0,2
7003,270.25,671,429,242,0.471
7004,312,708,439,269,0.414
7005,16.25,0,0,0,2
7006,293.75,700,435,265,0.43
7007,230.25,700,453,247,0.394
7008,231.75,720,449,271,0.382
7009,261,722,447,275,0.384
7010,12,0,0,0,2
7011,296.5,674,418,256,0.49
7012,19,0,0,0,2
7013,32.5,2,1,1,1.996
7014,228.25,670,431,239,0.468
7015,9,0,0,0,2
7016,6,0,0,0,2
7017,228.75,637,416,221,0.531
7018,36,1,0,1,1.999
7019,277.75,667,433,234,0.467
7020,22.5,2,2,0,1.994
7021,225.5,633,432,201,0.503
7022,269.5,716,442,274,0.4
7023,259.5,668,434,234,0.464
7024,237.75,740,457,283,0.346
7025,238,672,438,234,0.452
7026,330,619,406,213,0.569
7027,9.25,0,0,0,2
7028,230,680,435,245,0.45
7029,265.25,677,421,256,0.481
7030,265.75,661,433,228,0.473
7031,46,2,1,1,1.996
7032,314.5,663,434,229,0.469
7033,289,728,450,278,0.372
7034,19.25,0,0,0,2
7035,242,699,447,252,0.407
7036,24,0,0,0,2
7037,19.25,0,0,0,2
7038,52.5,3,3,0,1.991
7039,224,705,456,249,0.383
7040,235.25,653,419,234,0.509
7041,309.75,639,423,216,0.515
7042,32,1,1,0,1.997
7043,6.5,0,0,0,2
7044,239.5,700,445,255,0.41
7045,13.75,0,0,0,2
7046,18.5,0,0,0,2
7047,283,664,424,240,0.488
7048,258,702,441,261,0.416
7049,302.75,691,433,258,0.443
7050,23,2,1,1,1.996
7051,225,635,427,208,0.511
7052,211.5,654,423,231,0.5
7053,10.5,0,0,0,2
7054,16,0,0,0,2
7055,14.25,0,0,0,2
7056,294.25,690,438,252,0.434
7057,12.5,0,0,0,2
7058,303.25,724,450,274,0.376
7059,287.5,672,449,223,0.43
7060,271.25,715,456,259,0.373
7061,232.75,718,440,278,0.402
7062,20.5,0,0,0,2
7063,295.25,738,453,285,0.356
7064,298,665,415,250,0.505
7065,255.5,670,425,245,0.48
7066,339,671,431,240,0.467
7067,271.5,685,440,245,0.435
7068,263.75,643,425,218,0.507
7069,16,0,0,0,2
7070,297,691,448,243,0.413
7071,242.5,689,441,248,0.429
7072,21.5,1,0,1,1.999
7073,223.25,670,437,233,0.456
7074,312.75,686,430,256,0.454
7075,352.5,661,426,235,0.487
7076,230.25,696,445,251,0.414
7077,359,661,421,240,0.497
7078,226.75,677,431,246,0.461
7079,259.5,717,456,261,0.371
7080,261.5,669,432,237,0.467
7081,17.25,1,1,0,1.997
7082,27.5,1,1,0,1.997
7083,52,5,5,0,1.985
7084,9.75,0,0,0,2
7085,36.75,3,2,1,1.993
7086,266,678,431,247,0.46
7087,10,0,0,0,2
7088,320,702,445,257,0.408
7089,344.25,690,440,250,0.43
7090,226.25,693,444,249,0.419
7091,224.75,681,427,254,0.465
7092,312.75,696,445,251,0.414
7093,295.5,691,446,245,0.417
7094,219.5,657,430,227,0.483
7095,42.5,3,2,1,1.993
7096,262.5,704,447,257,0.402
7097,258,686,443,243,0.428
7098,287,694,446,248,0.414
7099,262.5,676,436,240,0.452
7100,247.75,694,447,247,0.412
7101,11.5,0,0,0,2
7102,33.75,1,1,0,1.997
7103,360.25,719,444,275,0.393
7104,7.25,0,0,0,2
7105,267.25,742,450,292,0.358
7106,300,735,447,288,0.371
7107,249.25,678,441,237,0.44
7108,255.75,696,443,253,0.418
7109,264.75,699,448,251,0.405
7110,225,705,448,257,0.399
7111,306,717,453,264,0.377
7112,8.5,0,0,0,2
7113,247.25,698,428,270,0.446
7114,287,669,423,246,0.485
7115,95.25,8,8,0,1.976
7116,234.25,726,444,282,0.386
7117,244.75,673,438,235,0.451
7118,30.5,0,0,0,2
7119,251,662,437,225,0.464
7120,32,1,1,0,1.997
7121,12.25,0,0,0,2
7122,240.25,671,430,241,0.469
7123,281.25,675,422,253,0.481
7124,14.5,0,0,0,2
7125,298.25,637,417,220,0.529
7126,266,616,406,210,0.572
7127,12.25,1,1,0,1.997
7128,233,710,445,265,0.4
7129,232.75,708,446,262,0.4
7130,280.5,681,430,251,0.459
7131,10,0,0,0,2
7132,272.75,709,445,264,0.401
7133,236.25,689,437,252,0.437
7134,351.75,658,413,245,0.516
7135,224.75,689,429,260,0.453
7136,12.5,0,0,0,2
7137,239.5,670,434,236,0.462
7138,17.25,0,0,0,2
7139,30.25,1,0,1,1.999
7140,231,685,440,245,0.435
7141,337.75,712,437,275,0.414
7142,4.75,0,0,0,2
7143,330.75,705,434,271,0.427
7144,9.25,0,0,0,2
7145,14.75,0,0,0,2
7146,229.75,692,442,250,0.424
7147,341.75,655,431,224,0.483
7148,21.75,0,0,0,2
7149,54.25,6,6,0,1.982
7150,232.5,700,449,251,0.402
7151,22.5,0,0,0,2
7152,245.5,691,444,247,0.421
7153,346.5,673,429,244,0.469
7154,315,645,415,230,0.525
7155,10.5,0,0,0,2
7156,10,0,0,0,2
7157,256,715,450,265,0.385
7158,307.75,682,429,253,0.46
7159,305,682,436,246,0.446
7160,273.75,686,440,246,0.434
7161,242,714,450,264,0.386
7162,233.75,723,459,264,0.359
7163,225.75,694,440,254,0.426
7164,346.75,689,436,253,0.439
7165,251.75,700,439,261,0.422
7166,249.25,716,446,270,0.392
7167,10,0,0,0,2
7168,244,658,433,225,0.476
7169,236.5,693,434,259,0.439
7170,269.5,701,447,254,0.405
7171,222.25,698,440,258,0.422
7172,260.25,705,445,260,0.405
7173,218.5,696,438,258,0.428
7174,298.5,705,440,265,0.415
7175,23.25,0,0,0,2
7176,254,693,446,247,0.415
7177,290.75,698,442,256,0.418
7178,293.5,707,444,263,0.405
7179,27.5,2,1,1,1.996
7180,212.75,702,441,261,0.416
7181,337.25,679,444,235,0.433
7182,291.5,730,458,272,0.354
7183,253.75,674,434,240,0.458
7184,217,686,430,256,0.454
7185,234.25,616,417,199,0.55
7186,46.25,4,1,3,1.994
7187,248.5,709,445,264,0.401
7188,14.75,0,0,0,2
7189,284.25,654,426,228,0.494
7190,310.25,666,421,245,0.492
7191,267.25,629,404,225,0.563
7192,212.25,672,438,234,0.452
7193,16.75,0,0,0,2
7194,28.75,2,1,1,1.996
7195,246.25,649,422,227,0.507
7196,251,678,431,247,0.46
7197,23.75,1,0,1,1.999
7198,267.5,667,439,228,0.455
7199,245.25,662,439,223,0.46
7200,257,713,456,257,0.375
7201,269,746,464,282,0.326
7202,7.75,0,0,0,2
7203,251.25,682,427,255,0.464
7204,37.25,2,1,1,1.996
7205,263.75,641,419,222,0.521
7206,17.25,0,0,0,2
7207,256,654,438,216,0.47
7208,24.5,0,0,0,2
7209,24.5,1,1,0,1.997
7210,246.75,662,436,226,0.466
7211,24.5,1,1,0,1.997
7212,339,675,435,240,0.455
7213,16,0,0,0,2
7214,220.25,688,439,249,0.434
7215,295.75,661,428,233,0.483
7216,269.25,710,446,264,0.398
7217,264,680,429,251,0.462
7218,233,650,434,216,0.482
7219,258,669,427,242,0.477
7220,238,723,451,272,0.375
7221,257.75,668,434,234,0.464
7222,283,713,436,277,0.415
7223,219.5,689,430,259,0.451
7224,251.25,649,430,219,0.491
7225,258.25,687,433,254,0.447
7226,23.25,0,0,0,2
7227,263,699,437,262,0.427
7228,16.25,0,0,0,2
7229,217.75,721,443,278,0.393
7230,7.75,0,0,0,2
7231,274.25,702,449,253,0.4
7232,273,704,452,252,0.392
7233,256.5,723,451,272,0.375
7234,256,675,427,248,0.471
7235,263,645,419,226,0.517
7236,233.75,711,452,259,0.385
7237,17,0,0,0,2
7238,291.75,701,448,253,0.403
7239,9,0,0,0,2
7240,331.75,709,449,260,0.393
7241,310.75,719,453,266,0.375
7242,300.75,659,433,226,0.475
7243,222,721,448,273,0.383
7244,244,694,449,245,0.408
7245,313.25,684,431,253,0.454
7246,262.75,698,438,260,0.426
7247,336.5,668,432,236,0.468
7248,234.75,667,436,231,0.461
7249,11.25,0,0,0,2
7250,9.5,0,0,0,2
7251,252.25,679,429,250,0.463
7252,260.25,666,426,240,0.482
7253,323.5,728,457,271,0.358
7254,274.25,670,425,245,0.48
7255,304,711,450,261,0.389
7256,265.5,650,426,224,0.498
7257,345.5,680,443,237,0.434
7258,242.25,712,445,267,0.398
7259,12,1,1,0,1.997
7260,312.75,673,420,253,0.487
7261,276.25,758,457,301,0.328
7262,35,2,2,0,1.994
7263,263.5,682,430,252,0.458
7264,253.75,685,435,250,0.445
7265,282.5,703,434,269,0.429
7266,240.25,700,446,254,0.408
7267,246.25,715,451,264,0.383
7268,290.25,685,446,239,0.423
7269,17.5,0,0,0,2
7270,242.5,679,439,240,0.443
7271,8.75,0,0,0,2
7272,15.5,0,0,0,2
7273,293,694,443,251,0.42
7274,293.25,626,411,215,0.552
7275,20.5,0,0,0,2
7276,8.75,0,0,0,2
7277,30.75,3,1,2,1.995
7278,218,719,447,272,0.387
7279,82.75,10,9,1,1.972
7280,285.25,675,417,258,0.491
7281,33.25,1,0,1,1.999
7282,286.5,689,434,255,0.443
7283,272,685,432,253,0.451
7284,257.25,671,419,252,0.491
7285,45.25,1,1,0,1.997
7286,10,0,0,0,2
7287,257.5,744,458,286,0.34
7288,304.25,695,447,248,0.411
7289,4.75,0,0,0,2
7290,297,699,444,255,0.413
7291,230.25,716,452,264,0.38
7292,11.25,0,0,0,2
7293,15.25,0,0,0,2
7294,15.25,0,0,0,2
7295,6.5,0,0,0,2
7296,20.75,1,1,0,1.997
7297,4.5,0,0,0,2
7298,335.75,691,436,255,0.437
7299,26.25,3,3,0,1.991
7300,341.5,700,431,269,0.438
7301,389,665,433,232,0.469
7302,287.5,719,451,268,0.379
7303,221.75,693,441,252,0.425
7304,301.5,663,430,233,0.477
7305,10,0,0,0,2
7306,309.25,657,424,233,0.495
7307,4.25,0,0,0,2
7308,221.25,699,443,256,0.415
7309,6,0,0,0,2
7310,22.5,0,0,0,2
7311,259.5,688,440,248,0.432
7312,184.25,584,397,187,0.622
7313,281,706,445,261,0.404
7314,306,682,442,240,0.434
7315,219.75,710,433,277,0.424
7316,336,694,443,251,0.42
7317,11.75,0,0,0,2
7318,239.25,683,436,247,0.445
7319,261.25,718,447,271,0.388
7320,222,675,429,246,0.467
7321,223.75,665,430,235,0.475
7322,14.75,0,0,0,2
7323,9,0,0,0,2
7324,5,0,0,0,2
7325,322.5,676,437,239,0.45
7326,13.5,1,1,0,1.997
7327,414.25,684,429,255,0.458
7328,451.25,664,426,238,0.484
7329,246.25,688,431,257,0.45
7330,13.25,0,0,0,2
7331,228.75,661,435,226,0.469
7332,251.5,691,440,251,0.429
7333,58.25,3,2,1,1.993
7334,211.5,699,447,252,0.407
7335,286.25,674,446,228,0.434
7336,255.75,697,437,260,0.429
7337,289,711,439,272,0.411
7338,247,663,435,228,0.467
7339,18,0,0,0,2
7340,33.5,0,0,0,2
7341,10,0,0,0,2
7342,298.25,672,427,245,0.474
7343,39.5,4,3,1,1.99
7344,9,0,0,0,2
7345,282.5,699,438,261,0.425
7346,284.25,674,433,241,0.46
7347,9.75,0,0,0,2
7348,298.25,702,439,263,0.42
7349,239.25,678,433,245,0.456
7350,234,673,432,241,0.463
7351,289.25,727,464,263,0.345
7352,248,732,451,281,0.366
7353,236.5,696,433,263,0.438
7354,209.25,698,434,264,0.434
7355,273.75,670,446,224,0.438
7356,13.25,0,0,0,2
7357,224,666,418,248,0.498
7358,10.25,0,0,0,2
7359,259.75,698,439,259,0.424
7360,278.5,739,449,290,0.363
7361,230.5,705,442,263,0.411
7362,257.25,670,427,243,0.476
7363,274.75,645,414,231,0.527
7364,51.75,1,1,0,1.997
7365,25.25,2,2,0,1.994
7366,10.75,0,0,0,2
7367,247.5,686,440,246,0.434
7368,62.75,1,1,0,1.997
7369,14.75,0,0,0,2
7370,248.25,669,436,233,0.459
7371,27.5,2,2,0,1.994
7372,257.25,646,400,246,0.554
7373,268.25,633,406,227,0.555
7374,16.5,0,0,0,2
7375,276.75,703,436,267,0.425
7376,232,686,430,256,0.454
7377,16.75,0,0,0,2
7378,221.5,730,459,271,0.352
7379,248,690,420,270,0.47
7380,228.5,684,433,251,0.45
7381,257.5,692,431,261,0.446
7382,265.75,663,424,239,0.489
7383,279,675,427,248,0.471
7384,292.75,700,446,254,0.408
7385,9.5,0,0,0,2
7386,238.25,710,447,263,0.396
7387,315.25,702,431,271,0.436
7388,296,714,448,266,0.39
7389,297,714,439,275,0.408
7390,21.75,0,0,0,2
7391,203,707,448,259,0.397
7392,379.25,716,439,277,0.406
7393,275.5,642,411,231,0.536
7394,15.75,1,1,0,1.997
7395,13,0,0,0,2
7396,245.5,704,441,263,0.414
7397,254,710,457,253,0.376
7398,24,2,1,1,1.996
7399,269.75,683,449,234,0.419
7400,279.5,664,428,236,0.48
7401,309.25,697,439,258,0.425
7402,317.75,679,435,244,0.451
7403,312.5,707,445,262,0.403
7404,14.25,0,0,0,2
7405,31,2,2,0,1.994
7406,269.75,667,426,241,0.481
7407,309,659,437,222,0.467
7408,260.75,672,429,243,0.47
7409,23.25,0,0,0,2
7410,219.5,713,431,282,0.425
7411,53,3,3,0,1.991
7412,271.25,675,438,237,0.449
7413,24,0,0,0,2
7414,259.25,646,428,218,0.498
7415,306,719,448,271,0.385
7416,54,3,3,0,1.991
7417,22.25,1,1,0,1.997
7418,214.75,659,422,237,0.497
7419,268.5,672,441,231,0.446
7420,203,658,430,228,0.482
7421,11.25,0,0,0,2
7422,316.25,660,414,246,0.512
7423,213.5,653,419,234,0.509
7424,229,688,443,245,0.426
7425,59.25,6,6,0,1.982
7426,11,1,0,1,1.999
7427,38,1,0,1,1.999
7428,28,0,0,0,2
7429,18.75,0,0,0,2
7430,54.5,2,0,2,1.998
7431,220.5,688,431,257,0.45
7432,245,704,448,256,0.4
7433,304.25,664,433,231,0.47
7434,36.75,1,1,0,1.997
7435,281.5,641,419,222,0.521
7436,285.5,683,448,235,0.421
7437,244.25,697,438,259,0.427
7438,292.25,667,421,246,0.491
7439,326.5,709,442,267,0.407
7440,323.5,670,419,251,0.492
7441,304.75,692,428,264,0.452
7442,318.75,699,432,267,0.437
7443,23.25,0,0,0,2
7444,361.5,666,430,236,0.474
7445,273.5,720,444,276,0.392
7446,274.5,682,440,242,0.438
7447,268,701,443,258,0.413
7448,244,664,438,226,0.46
7449,38.5,1,0,1,1.999
7450,246,707,442,265,0.409
7451,26.5,3,3,0,1.991
7452,9.25,0,0,0,2
7453,261.5,727,453,274,0.367
7454,277,635,417,218,0.531
7455,238.25,702,436,266,0.426
7456,264.25,592,405,187,0.598
7457,302.25,680,436,244,0.448
7458,272.5,638,422,216,0.518
7459,260.75,733,449,284,0.369
7460,16.25,0,0,0,2
7461,271.25,713,444,269,0.399
7462,33.5,1,1,0,1.997
7463,41.75,4,4,0,1.988
7464,15,0,0,0,2
7465,11.25,0,0,0,2
7466,237,670,437,233,0.456
7467,253.25,661,436,225,0.467
7468,230.5,709,444,265,0.403
7469,221.5,704,442,262,0.412
7470,26,0,0,0,2
7471,253.25,682,440,242,0.438
7472,202.5,701,442,259,0.415
7473,304,678,440,238,0.442
7474,384.75,675,426,249,0.473
7475,47,1,1,0,1.997
7476,301.75,659,432,227,0.477
7477,228,683,449,234,0.419
7478,283.75,694,440,254,0.426
7479,344.5,654,438,216,0.47
7480,15,0,0,0,2
7481,43,3,2,1,1.993
7482,8,0,0,0,2
7483,233,693,444,249,0.419
7484,13.5,0,0,0,2
7485,248,673,423,250,0.481
7486,252.25,710,445,265,0.4
7487,241.5,699,434,265,0.433
7488,246.5,634,418,216,0.53
7489,284.5,675,430,245,0.465
7490,15.5,1,1,0,1.997
7491,242.5,705,434,271,0.427
7492,254.5,663,418,245,0.501
7493,10.25,0,0,0,2
7494,354.25,670,441,229,0.448
7495,232.75,647,410,237,0.533
7496,26.5,1,1,0,1.997
7497,44.5,5,5,0,1.985
7498,237.5,699,434,265,0.433
7499,196.5,698,446,252,0.41
7500,242.75,717,446,271,0.391
7501,223.5,744,451,293,0.354
7502,257.75,688,440,248,0.432
7503,277,708,453,255,0.386
7504,255.5,668,434,234,0.464
7505,273.5,690,440,250,0.43
7506,238.25,681,434,247,0.451
7507,333,718,446,272,0.39
7508,9.25,0,0,0,2
7509,312.25,700,442,258,0.416
7510,10.25,0,0,0,2
7511,272.25,686,439,247,0.436
7512,329.25,681,433,248,0.453
7513,7.5,0,0,0,2
7514,249,696,442,254,0.42
7515,26.75,2,1,1,1.996
7516,240.75,683,435,248,0.447
7517,23.5,0,0,0,2
7518,7,0,0,0,2
7519,258.5,683,437,246,0.443
7520,8.75,0,0,0,2
7521,255.75,700,441,259,0.418
7522,14.75,0,0,0,2
7523,245.25,690,433,257,0.444
7524,278,717,455,262,0.373
7525,17.75,1,1,0,1.997
7526,15.25,1,1,0,1.997
7527,313,706,446,260,0.402
7528,287,711,455,256,0.379
7529,11,0,0,0,2
7530,392,639,422,217,0.517
7531,23.75,0,0,0,2
7532,346.5,646,434,212,0.486
7533,253.75,685,428,257,0.459
7534,247.5,666,425,241,0.484
7535,229.5,682,435,247,0.448
7536,51.5,2,1,1,1.996
7537,245,670,430,240,0.47
7538,223,687,437,250,0.439
7539,42,5,5,0,1.985
7540,9.25,0,0,0,2
7541,12.75,0,0,0,2
7542,311.5,675,440,235,0.445
7543,246.5,636,414,222,0.536
7544,347.75,665,421,244,0.493
7545,293.25,679,428,251,0.465
7546,251,727,453,274,0.367
7547,248.5,695,433,262,0.439
7548,339,645,424,221,0.507
7549,16,0,0,0,2
7550,12.5,0,0,0,2
7551,272.75,671,434,237,0.461
7552,8.25,0,0,0,2
7553,42.75,2,1,1,1.996
7554,286.75,649,422,227,0.507
7555,259.25,643,427,216,0.503
7556,202.25,671,425,246,0.479
7557,25,1,1,0,1.997
7558,270.75,738,461,277,0.34
7559,218.75,676,417,259,0.49
7560,292.5,649,418,231,0.515
7561,287,677,431,246,0.461
7562,227.75,706,443,263,0.408
7563,253.25,689,432,257,0.447
7564,212.25,698,447,251,0.408
7565,253,733,464,269,0.339
7566,264.75,732,438,294,0.392
7567,250.75,712,452,260,0.384
7568,24,1,0,1,1.999
7569,279.75,658,420,238,0.502
7570,17.25,0,0,0,2
7571,293.25,662,437,225,0.464
7572,22,2,2,0,1.994
7573,316.25,664,414,250,0.508
7574,289.5,666,429,237,0.476
7575,281.5,628,402,226,0.568
7576,260.75,664,439,225,0.458
7577,29.5,3,2,1,1.993
7578,272.75,701,449,252,0.401
7579,266,623,404,219,0.569
7580,11.75,0,0,0,2
7581,53,4,4,0,1.988
7582,193,693,436,257,0.435
7583,287.5,655,424,231,0.497
7584,295.5,666,425,241,0.484
7585,241.75,649,429,220,0.493
7586,82.5,14,10,4,1.966
7587,384.5,642,422,220,0.514
7588,275.25,681,434,247,0.451
7589,412.75,660,432,228,0.476
7590,203.75,700,429,271,0.442
7591,269.25,718,452,266,0.378
7592,26.5,1,0,1,1.999
7593,220.75,687,438,249,0.437
7594,24.25,2,2,0,1.994
7595,7.5,0,0,0,2
7596,302,633,422,211,0.523
7597,20,0,0,0,2
7598,39.75,8,7,1,1.978
7599,13.75,0,0,0,2
7600,10.75,0,0,0,2
7601,294.25,672,433,239,0.462
7602,246.5,672,429,243,0.47
7603,273,663,432,231,0.473
7604,8,0,0,0,2
7605,14.5,0,0,0,2
7606,296,682,437,245,0.444
7607,10,0,0,0,2
7608,264.5,718,455,263,0.372
7609,10.5,0,0,0,2
7610,20,0,0,0,2
7611,44.25,8,6,2,1.98
7612,231.25,702,446,256,0.406
7613,234.5,670,429,241,0.472
7614,39.5,4,4,0,1.988
7615,34.25,1,1,0,1.997
7616,9,0,0,0,2
7617,222.25,623,412,211,0.553
7618,254.5,664,428,236,0.48
7619,268.25,640,417,223,0.526
7620,44.5,3,3,0,1.991
7621,212,715,453,262,0.379
7622,42.75,3,3,0,1.991
7623,38.25,1,0,1,1.999
7624,271.25,707,457,250,0.379
7625,8.25,0,0,0,2
7626,335,690,433,257,0.444
7627,260.5,699,443,256,0.415
7628,16,0,0,0,2
7629,257,690,441,249,0.428
7630,267.75,703,442,261,0.413
7631,12.25,0,0,0,2
7632,18,0,0,0,2
7633,33.75,1,0,1,1.999
7634,16.75,0,0,0,2
7635,240.75,712,441,271,0.406
7636,233.75,676,431,245,0.462
7637,19.75,0,0,0,2
7638,241.5,673,434,239,0.459
7639,240,677,431,246,0.461
7640,203.25,683,445,238,0.427
7641,177,721,456,265,0.367
7642,282.25,662,419,243,0.5
7643,266.5,669,424,245,0.483
7644,265.25,688,429,259,0.454
7645,259,737,447,290,0.369
7646,293.5,694,443,251,0.42
7647,30.5,0,0,0,2
7648,228.75,676,433,243,0.458
7649,27.5,0,0,0,2
7650,282.75,679,437,242,0.447
7651,282.25,686,430,256,0.454
7652,24.5,0,0,0,2
7653,230.5,635,420,215,0.525
7654,215.75,713,447,266,0.393
7655,241.25,685,432,253,0.451
7656,267.75,679,442,237,0.437
7657,12.25,0,0,0,2
7658,231,702,450,252,0.398
7659,266.25,688,443,245,0.426
7660,210,695,446,249,0.413
7661,292,716,453,263,0.378
7662,238.75,672,423,249,0.482
7663,312.5,690,443,247,0.424
7664,279.5,695,426,269,0.453
7665,17.25,0,0,0,2
7666,337.25,622,408,214,0.562
7667,249,673,442,231,0.443
7668,276.75,717,453,264,0.377
7669,273,677,438,239,0.447
7670,258,663,431,232,0.475
7671,273,677,434,243,0.455
7672,295.25,652,424,228,0.5
7673,2.25,0,0,0,2
7674,270.25,701,442,259,0.415
7675,37,1,1,0,1.997
7676,247,679,429,250,0.463
7677,232.75,710,439,271,0.412
7678,263.75,709,448,261,0.395
7679,225,679,419,260,0.483
7680,7.25,0,0,0,2
7681,269,689,425,264,0.461
7682,16.5,0,0,0,2
7683,20.25,0,0,0,2
7684,306,722,442,280,0.394
7685,260.25,674,431,243,0.464
7686,198,726,452,274,0.37
7687,358.25,678,425,253,0.472
7688,298.25,686,436,250,0.442
7689,8.25,0,0,0,2
7690,36.75,1,1,0,1.997
7691,247.5,685,432,253,0.451
7692,261,674,438,236,0.45
7693,13.75,0,0,0,2
7694,250,665,438,227,0.459
7695,231.5,724,444,280,0.388
7696,252.25,653,416,237,0.515
7697,23.5,0,0,0,2
7698,13.25,1,1,0,1.997
7699,9.25,0,0,0,2
7700,282.25,671,423,248,0.483
7701,275,655,434,221,0.477
7702,232,665,436,229,0.463
7703,29.5,1,1,0,1.997
7704,256.75,636,420,216,0.524
7705,16.5,0,0,0,2
7706,261.25,685,438,247,0.439
7707,275.25,678,446,232,0.43
7708,290.25,710,450,260,0.39
7709,238.75,673,438,235,0.451
7710,265.75,703,437,266,0.423
7711,241.25,720,449,271,0.382
7712,6.75,0,0,0,2
7713,55.5,0,0,0,2
7714,230,709,447,262,0.397
7715,5.5,0,0,0,2
7716,11.5,0,0,0,2
7717,255.5,658,428,230,0.486
7718,30.75,2,1,1,1.996
7719,347.5,711,441,270,0.407
7720,273.5,715,438,277,0.409
7721,337,645,428,217,0.499
7722,4.75,0,0,0,2
7723,257,658,421,237,0.5
7724,35.5,0,0,0,2
7725,265,626,400,226,0.574
7726,233.75,732,460,272,0.348
7727,5.75,0,0,0,2
7728,300,592,403,189,0.602
7729,270.75,641,422,219,0.515
7730,6.25,0,0,0,2
7731,268,701,439,262,0.421
7732,24,0,0,0,2
7733,310.75,694,426,268,0.454
7734,286.25,665,433,232,0.469
7735,237.5,696,439,257,0.426
7736,29,0,0,0,2
7737,21,0,0,0,2
7738,25.5,1,0,1,1.999
7739,212.5,692,443,249,0.422
7740,317.25,683,434,249,0.449
7741,26.75,1,1,0,1.997
7742,284.5,696,433,263,0.438
7743,283,675,433,242,0.459
7744,324.25,689,431,258,0.449
7745,243.25,703,442,261,0.413
7746,221.25,695,438,257,0.429
7747,265.75,666,424,242,0.486
7748,252,686,436,250,0.442
7749,285.75,719,446,273,0.389
7750,233,684,436,248,0.444
7751,336,705,438,267,0.419
7752,286.5,740,449,291,0.362
7753,265.5,667,434,233,0.465
7754,269.75,678,428,250,0.466
7755,279.25,654,429,225,0.488
7756,326,650,417,233,0.516
7757,290,676,415,261,0.494
7758,275.25,638,419,219,0.524
7759,257.25,662,426,236,0.486
7760,255.5,705,456,249,0.383
7761,200.25,683,425,258,0.467
7762,13.5,0,0,0,2
7763,26.5,0,0,0,2
7764,222.75,743,452,291,0.353
7765,285.75,711,456,255,0.377
7766,270.5,639,425,214,0.511
7767,28.5,2,1,1,1.996
7768,263.5,697,443,254,0.417
7769,231.75,673,431,242,0.465
7770,19.75,0,0,0,2
7771,268,665,427,238,0.481
7772,233.25,673,439,234,0.449
7773,229.25,686,446,240,0.422
7774,274,712,438,274,0.412
7775,272.25,702,445,257,0.408
7776,235.25,714,442,272,0.402
7777,17.75,1,0,1,1.999
7778,6.75,0,0,0,2
7779,287.75,702,433,269,0.432
7780,15.75,0,0,0,2
7781,283.5,690,433,257,0.444
7782,201.5,640,424,216,0.512
7783,175.25,679,434,245,0.453
7784,295.5,700,440,260,0.42
7785,243.5,711,444,267,0.401
7786,305,660,437,223,0.466
7787,256.75,694,436,258,0.434
7788,261,640,425,215,0.51
7789,7,0,0,0,2
7790,306,661,420,241,0.499
7791,274.25,633,422,211,0.523
7792,265.75,676,426,250,0.472
7793,249,703,449,254,0.399
7794,11,0,0,0,2
7795,215,719,449,270,0.383
7796,67.25,3,2,1,1.993
7797,5.5,0,0,0,2
7798,59.5,5,3,2,1.989
7799,261.5,682,441,241,0.436
7800,300.75,697,439,258,0.425
7801,66.25,5,4,1,1.987
7802,286.5,737,452,285,0.359
7803,242.25,665,432,233,0.471
7804,22.75,0,0,0,2
7805,9.25,0,0,0,2
7806,256,641,431,210,0.497
7807,20.25,1,1,0,1.997
7808,31.75,2,2,0,1.994
7809,26,7,5,2,1.983
7810,14,0,0,0,2
7811,67.75,6,3,3,1.988
7812,262.5,672,433,239,0.462
7813,33.75,1,1,0,1.997
7814,229.75,695,433,262,0.439
7815,271.75,731,449,282,0.371
7816,233.5,674,434,240,0.458
7817,202.75,705,446,259,0.403
7818,26,0,0,0,2
7819,16.5,0,0,0,2
7820,235.25,689,440,249,0.431
7821,32.75,1,1,0,1.997
7822,273.75,698,445,253,0.412
7823,32.75,2,2,0,1.994
7824,262,704,441,263,0.414
7825,397.25,692,437,255,0.434
7826,248.5,694,436,258,0.434
7827,259.75,706,443,263,0.408
7828,272.5,657,430,227,0.483
7829,241.5,697,435,262,0.433
7830,273,678,431,247,0.46
7831,243.25,688,440,248,0.432
7832,314,702,441,261,0.416
7833,216,647,422,225,0.509
7834,223.75,698,449,249,0.404
7835,229,677,439,238,0.445
7836,21,0,0,0,2
7837,254.75,713,442,271,0.403
7838,278.5,679,432,247,0.457
7839,21,0,0,0,2
7840,222,745,445,300,0.365
7841,290.75,696,447,249,0.41
7842,229.5,669,437,232,0.457
7843,261.5,706,442,264,0.41
7844,347.5,676,445,231,0.434
7845,274.5,680,429,251,0.462
7846,25.75,1,0,1,1.999
7847,435,677,429,248,0.465
7848,241.25,716,441,275,0.402
7849,218.25,703,441,262,0.415
7850,257.25,715,445,270,0.395
7851,261,715,454,261,0.377
7852,276.75,705,438,267,0.419
7853,284.5,662,429,233,0.48
7854,194.75,672,438,234,0.452
7855,222.75,686,438,248,0.438
7856,287,640,416,224,0.528
7857,304.25,659,422,237,0.497
7858,297,696,433,263,0.438
7859,248,671,433,238,0.463
7860,250.75,727,450,277,0.373
7861,257,730,450,280,0.37
7862,237.75,663,429,234,0.479
7863,251,684,425,259,0.466
7864,316.75,694,437,257,0.432
7865,251.75,711,449,262,0.391
7866,318,648,419,229,0.514
7867,15.5,1,1,0,1.997
7868,28.25,2,2,0,1.994
7869,295.5,661,428,233,0.483
7870,203.25,713,442,271,0.403
7871,252.25,688,435,253,0.442
7872,15,0,0,0,2
7873,35,2,2,0,1.994
7874,7,0,0,0,2
7875,248.75,715,449,266,0.387
7876,17.25,0,0,0,2
7877,271.5,700,458,242,0.384
7878,6.75,0,0,0,2
7879,8.25,0,0,0,2
7880,237.25,688,441,247,0.43
7881,2.5,0,0,0,2
7882,236.25,685,441,244,0.433
7883,5,0,0,0,2
7884,23,1,1,0,1.997
7885,250.75,662,430,232,0.478
7886,274.75,659,428,231,0.485
7887,228.75,756,464,292,0.316
7888,11.5,0,0,0,2
7889,283.75,734,457,277,0.352
7890,55.5,2,2,0,1.994
7891,236.5,695,448,247,0.409
7892,6.75,0,0,0,2
7893,374.75,717,450,267,0.383
7894,47.5,1,1,0,1.997
7895,275.75,719,447,272,0.387
7896,10.75,0,0,0,2
7897,55,0,0,0,2
7898,243.25,662,427,235,0.484
7899,22,1,1,0,1.997
7900,19.25,0,0,0,2
7901,302.25,728,451,277,0.37
7902,9,0,0,0,2
7903,291.75,695,450,245,0.405
7904,49.25,3,3,0,1.991
7905,20.5,0,0,0,2
7906,263.75,664,438,226,0.46
7907,254.5,667,434,233,0.465
7908,241.5,653,423,230,0.501
7909,69.25,15,11,4,1.963
7910,266.75,661,421,240,0.497
7911,268.5,680,431,249,0.458
7912,254.75,696,463,233,0.378
7913,271.25,706,440,266,0.414
7914,263.25,694,443,251,0.42
7915,264.75,721,431,290,0.417
7916,234.75,675,438,237,0.449
7917,49.75,2,1,1,1.996
7918,26.25,0,0,0,2
7919,273.75,724,445,279,0.386
7920,7.25,0,0,0,2
7921,255.5,680,442,238,0.436
7922,254.75,674,432,242,0.462
7923,270,678,434,244,0.454
7924,197.75,707,442,265,0.409
7925,23.75,0,0,0,2
7926,276.25,662,414,248,0.51
7927,273,700,444,256,0.412
7928,240.25,683,440,243,0.437
7929,261,688,421,267,0.47
7930,248.75,716,439,277,0.406
7931,14,0,0,0,2
7932,27,0,0,0,2
7933,238.25,670,426,244,0.478
7934,23,1,1,0,1.997
7935,261.5,653,430,223,0.487
7936,227.75,687,440,247,0.433
7937,15,0,0,0,2
7938,21.25,0,0,0,2
7939,208.75,645,422,223,0.511
7940,7.75,0,0,0,2
7941,14.75,0,0,0,2
7942,300.25,685,431,254,0.453
7943,228,699,433,266,0.435
7944,282.75,680,436,244,0.448
7945,265.5,704,455,249,0.386
7946,205,675,426,249,0.473
7947,226.25,638,412,226,0.538
7948,16,0,0,0,2
7949,10.75,1,1,0,1.997
7950,17.25,0,0,0,2
7951,23.5,0,0,0,2
7952,14.25,0,0,0,2
7953,32.75,0,0,0,2
7954,281.75,640,419,221,0.522
7955,257.75,713,456,257,0.375
7956,6.75,0,0,0,2
7957,8.5,0,0,0,2
7958,297.75,667,420,247,0.493
7959,267.5,685,448,237,0.419
7960,226.25,672,424,248,0.48
7961,235,663,428,235,0.481
7962,28.5,0,0,0,2
7963,281.5,653,420,233,0.507
7964,256,663,418,245,0.501
7965,289.75,719,454,265,0.373
7966,222.25,661,429,232,0.481
7967,13.25,0,0,0,2
7968,14.25,0,0,0,2
7969,234.25,676,441,235,0.442
7970,12.5,0,0,0,2
7971,236.75,639,420,219,0.521
7972,270.25,679,440,239,0.441
7973,265.5,666,420,246,0.494
7974,4.25,0,0,0,2
7975,343.5,640,421,219,0.518
7976,313.25,687,432,255,0.449
7977,260,690,445,245,0.42
7978,279,676,425,251,0.474
7979,214.25,683,439,244,0.439
7980,263.5,673,429,244,0.469
7981,20,2,1,1,1.996
7982,14.5,1,0,1,1.999
7983,251.25,675,445,230,0.435
7984,271,684,429,255,0.458
7985,230.25,696,458,238,0.388
7986,15.25,0,0,0,2
7987,267.75,681,426,255,0.467
7988,16.5,1,1,0,1.997
7989,20,0,0,0,2
7990,271.75,672,436,236,0.456
7991,259.5,619,410,209,0.561
7992,10.5,0,0,0,2
7993,444.75,645,416,229,0.523
7994,234.5,631,416,215,0.537
7995,249,683,436,247,0.445
7996,341.5,673,426,247,0.475
7997,274,671,434,237,0.461
7998,5.75,0,0,0,2
7999,213,643,409,234,0.539
8000,9.75,0,0,0,2
8001,249.25,665,435,230,0.465
8002,271.25,664,415,249,0.506
8003,234.75,676,421,255,0.482
8004,259.5,703,438,265,0.421
8005,252.25,697,442,255,0.419
8006,256.75,761,459,302,0.321
8007,314.75,666,419,247,0.496
8008,12.5,1,1,0,1.997
8009,224,707,451,256,0.391
8010,258.75,690,435,255,0.44
8011,34.25,0,0,0,2
8012,29,1,1,0,1.997
8013,264,671,433,238,0.463
8014,39.75,0,0,0,2
8015,328.5,701,437,264,0.425
8016,228,661,426,235,0.487
8017,280,742,449,293,0.36
8018,262.5,672,429,243,0.47
8019,332.75,688,433,255,0.446
8020,11.75,0,0,0,2
8021,275.5,689,435,254,0.441
8022,267.5,675,425,250,0.475
8023,56,2,2,0,1.994
8024,240,701,444,257,0.411
8025,197.75,708,443,265,0.406
8026,12.25,0,0,0,2
8027,220.25,735,453,282,0.359
8028,32.75,1,0,1,1.999
8029,269.75,630,416,214,0.538
8030,292,710,452,258,0.386
8031,16.25,0,0,0,2
8032,15.5,0,0,0,2
8033,200.5,691,445,246,0.419
8034,14.25,0,0,0,2
8035,240.25,713,459,254,0.369
8036,286.25,713,441,272,0.405
8037,18.25,0,0,0,2
8038,223,720,447,273,0.386
8039,295.5,694,438,256,0.43
8040,10,1,1,0,1.997
8041,293,679,432,247,0.457
8042,303.5,697,446,251,0.411
8043,295,688,443,245,0.426
8044,214,685,439,246,0.437
8045,11,1,0,1,1.999
8046,286,703,440,263,0.417
8047,248.5,660,432,228,0.476
8048,29.75,1,1,0,1.997
8049,252,715,441,274,0.403
8050,8,0,0,0,2
8051,271.25,740,452,288,0.356
8052,264.75,695,437,258,0.431
8053,63.5,4,2,2,1.992
8054,17,0,0,0,2
8055,17,0,0,0,2
8056,253.75,637,423,214,0.517
8057,256.5,655,438,217,0.469
8058,29,1,1,0,1.997
8059,244.25,719,458,261,0.365
8060,14.25,0,0,0,2
8061,384.5,669,421,248,0.489
8062,268.25,704,441,263,0.414
8063,16.75,0,0,0,2
8064,27.25,1,0,1,1.999
8065,13.25,0,0,0,2
8066,251.5,647,428,219,0.497
8067,257.5,724,449,275,0.378
8068,288.5,637,404,233,0.555
8069,238.25,693,439,254,0.429
8070,241.25,658,439,219,0.464
8071,232.5,672,423,249,0.482
8072,253.5,684,438,246,0.44
8073,215.5,667,435,232,0.463
8074,257,684,441,243,0.434
8075,301.75,666,429,237,0.476
8076,209.5,644,426,218,0.504
8077,260.25,684,433,251,0.45
8078,22.25,0,0,0,2
8079,234.75,665,419,246,0.497
8080,301.5,713,445,268,0.397
8081,7,0,0,0,2
8082,298.5,686,431,255,0.452
8083,18.25,0,0,0,2
8084,289.75,703,445,258,0.407
8085,290.5,659,419,240,0.503
8086,28.25,2,2,0,1.994
8087,24.75,2,0,2,1.998
8088,238,694,438,256,0.43
8089,2.75,0,0,0,2
8090,298.5,719,445,274,0.391
8091,274.25,734,463,271,0.34
8092,292,662,436,226,0.466
8093,303.75,695,438,257,0.429
8094,8.5,0,0,0,2
8095,255.5,698,448,250,0.406
8096,15,0,0,0,2
8097,24.75,2,2,0,1.994
8098,325.5,675,432,243,0.461
8099,18,0,0,0,2
8100,263.5,671,434,237,0.461
8101,263,668,444,224,0.444
8102,246.75,699,435,264,0.431
8103,216.5,660,424,236,0.492
8104,248,662,429,233,0.48
8105,220,672,441,231,0.446
8106,16.5,0,0,0,2
8107,348.25,671,431,240,0.467
8108,287,676,428,248,0.468
8109,10.5,0,0,0,2
8110,5.75,0,0,0,2
8111,6,0,0,0,2
8112,17.25,0,0,0,2
8113,390.75,701,424,277,0.451
8114,264.25,660,422,238,0.496
8115,16.5,0,0,0,2
8116,189.5,701,443,258,0.413
8117,239.25,658,419,239,0.504
8118,289.5,672,422,250,0.484
8119,262.75,665,433,232,0.469
8120,428,628,416,212,0.54
8121,258.5,716,448,268,0.388
8122,267.5,629,409,220,0.553
8123,256.5,718,450,268,0.382
8124,268,636,418,218,0.528
8125,224.25,632,409,223,0.55
8126,309.75,660,431,229,0.478
8127,331.25,656,414,242,0.516
8128,238.5,681,433,248,0.453
8129,326,673,419,254,0.489
8130,241,677,429,248,0.465
8131,233.25,713,447,266,0.393
8132,218.5,710,445,265,0.4
8133,36.25,0,0,0,2
8134,12.25,0,0,0,2
8135,236.25,692,433,259,0.442
8136,274.25,663,434,229,0.469
8137,41.75,1,0,1,1.999
8138,10.5,0,0,0,2
8139,9.5,0,0,0,2
8140,248,656,440,216,0.464
8141,301,677,436,241,0.451
8142,21,0,0,0,2
8143,16.75,0,0,0,2
8144,282.75,700,441,259,0.418
8145,259.25,729,443,286,0.385
8146,314.5,651,414,237,0.521
8147,27,0,0,0,2
8148,345.25,643,428,215,0.501
8149,291.5,705,453,252,0.389
8150,201.75,683,440,243,0.437
8151,299.25,684,439,245,0.438
8152,266.25,669,436,233,0.459
8153,31.75,0,0,0,2
8154,4.75,0,0,0,2
8155,308.75,645,415,230,0.525
8156,18.5,0,0,0,2
8157,14.25,2,1,1,1.996
8158,27.5,0,0,0,2
8159,39,3,1,2,1.995
8160,59.5,6,5,1,1.984
8161,20,1,1,0,1.997
8162,278.5,685,439,246,0.437
8163,296,678,440,238,0.442
8164,13,0,0,0,2
8165,240.75,700,434,266,0.432
8166,259.25,692,450,242,0.408
8167,8.25,0,0,0,2
8168,27.5,0,0,0,2
8169,254,698,439,259,0.424
8170,7.5,0,0,0,2
8171,237.25,673,419,254,0.489
8172,237.75,669,430,239,0.471
8173,8.75,0,0,0,2
8174,235,691,439,252,0.431
8175,288,682,449,233,0.42
8176,237,682,431,251,0.456
8177,226.75,624,404,220,0.568
8178,229,738,451,287,0.36
8179,285.25,682,442,240,0.434
8180,17.5,0,0,0,2
8181,300.25,644,415,229,0.526
8182,262,674,416,258,0.494
8183,54.5,3,2,1,1.993
8184,276.75,664,430,234,0.476
8185,6.25,0,0,0,2
8186,288.5,701,449,252,0.401
8187,259.25,707,433,274,0.427
8188,237.5,708,446,262,0.4
8189,212.5,670,439,231,0.452
8190,10.5,0,0,0,2
8191,248.25,667,433,234,0.467
8192,301.5,679,440,239,0.441
8193,361.25,662,427,235,0.484
8194,288.25,688,435,253,0.442
8195,303,689,446,243,0.419
8196,6,0,0,0,2
8197,240.5,695,439,256,0.427
8198,44.75,2,1,1,1.996
8199,279.75,697,437,260,0.429
8200,275.75,645,427,218,0.501
8201,234.5,666,437,229,0.46
8202,292.25,714,432,282,0.422
8203,348,700,444,256,0.412
8204,13.75,0,0,0,2
8205,10.75,0,0,0,2
8206,291,716,448,268,0.388
8207,280.5,643,418,225,0.521
8208,14.25,0,0,0,2
8209,230,706,436,270,0.422
8210,306.25,667,428,239,0.477
8211,239.5,711,457,254,0.375
8212,311,638,423,215,0.516
8213,22,0,0,0,2
8214,26.75,1,1,0,1.997
8215,306.75,592,402,190,0.604
8216,344.5,658,430,228,0.482
8217,35.75,1,1,0,1.997
8218,266.5,691,444,247,0.421
8219,9,0,0,0,2
8220,31.5,0,0,0,2
8221,396,684,445,239,0.426
8222,273.75,692,436,256,0.436
8223,358,656,427,229,0.49
8224,259,688,436,252,0.44
8225,255,658,426,232,0.49
8226,289.75,703,444,259,0.409
8227,226.5,689,434,255,0.443
8228,190.75,661,438,223,0.463
8229,250.75,653,436,217,0.475
8230,8.75,0,0,0,2
8231,254.75,683,432,251,0.453
8232,24.5,0,0,0,2
8233,253.5,700,435,265,0.43
8234,36,3,3,0,1.991
8235,249.25,676,434,242,0.456
8236,11,0,0,0,2
8237,233.5,706,458,248,0.378
8238,254.5,697,447,250,0.409
8239,248.5,723,446,277,0.385
8240,232,655,425,230,0.495
8241,237.25,663,434,229,0.469
8242,12.25,0,0,0,2
8243,331.75,680,425,255,0.47
8244,250,633,424,209,0.519
8245,224.75,685,444,241,0.427
8246,6.5,0,0,0,2
8247,11.25,0,0,0,2
8248,295,662,430,232,0.478
8249,288.25,687,428,259,0.457
8250,29,0,0,0,2
8251,246.5,717,441,276,0.401
8252,285.75,706,442,264,0.41
8253,10.5,1,1,0,1.997
8254,297.75,682,439,243,0.44
8255,271.75,628,420,208,0.532
8256,317.25,696,428,268,0.448
8257,6.25,0,0,0,2
8258,32.75,3,3,0,1.991
8259,220,700,440,260,0.42
8260,239.75,682,444,238,0.43
8261,9.25,0,0,0,2
8262,23.75,0,0,0,2
8263,269.75,627,409,218,0.555
8264,268.25,717,444,273,0.395
8265,247.25,737,452,285,0.359
8266,268,676,414,262,0.496
8267,6.75,0,0,0,2
8268,35.75,2,2,0,1.994
8269,32.75,0,0,0,2
8270,270.25,615,405,210,0.575
8271,235.75,701,444,257,0.411
8272,314.25,702,439,263,0.42
8273,353,681,437,244,0.445
8274,18.25,1,1,0,1.997
8275,273.25,681,424,257,0.471
8276,259,662,436,226,0.466
8277,268.5,688,434,254,0.444
8278,204.25,714,442,272,0.402
8279,277.5,697,442,255,0.419
8280,337.5,673,437,236,0.453
8281,26.75,1,1,0,1.997
8282,11,0,0,0,2
8283,39.75,3,3,0,1.991
8284,257.75,674,432,242,0.462
8285,226,731,464,267,0.341
8286,250.25,690,438,252,0.434
8287,16.75,0,0,0,2
8288,332.25,672,439,233,0.45
8289,292.75,615,403,212,0.579
8290,276.75,655,430,225,0.485
8291,260.75,722,440,282,0.398
8292,296.25,677,434,243,0.455
8293,222.5,681,435,246,0.449
8294,257.25,691,439,252,0.431
8295,283.75,679,427,252,0.467
8296,222.75,597,390,207,0.623
8297,311.75,678,437,241,0.448
8298,258,694,432,262,0.442
8299,278.25,637,420,217,0.523
8300,5,0,0,0,2
8301,272.25,687,437,250,0.439
8302,306.5,689,446,243,0.419
8303,273.25,708,451,257,0.39
8304,8.25,0,0,0,2
8305,366.5,713,451,262,0.385
8306,259.25,655,423,232,0.499
8307,252.25,657,422,235,0.499
8308,7.25,0,0,0,2
8309,13.75,0,0,0,2
8310,273.25,617,415,202,0.553
8311,272.75,738,453,285,0.356
8312,248,693,436,257,0.435
8313,324.75,648,415,233,0.522
8314,241.5,700,440,260,0.42
8315,227,642,425,217,0.508
8316,276.25,692,442,250,0.424
8317,237.25,698,434,264,0.434
8318,234.25,679,437,242,0.447
8319,38,1,1,0,1.997
8320,287.5,710,432,278,0.426
8321,272.25,647,422,225,0.509
8322,198,652,430,222,0.488
8323,373.5,694,437,257,0.432
8324,243.5,643,415,228,0.527
8325,64.75,4,3,1,1.99
8326,244.75,689,439,250,0.433
8327,19.5,0,0,0,2
8328,261,683,437,246,0.443
8329,274.5,690,428,262,0.454
8330,309.75,648,413,235,0.526
8331,249,659,430,229,0.481
8332,45.5,1,0,1,1.999
8333,11.75,0,0,0,2
8334,12.25,0,0,0,2
8335,21.25,1,1,0,1.997
8336,268.25,647,424,223,0.505
8337,234.25,662,434,228,0.47
8338,332.75,616,408,208,0.568
8339,11,0,0,0,2
8340,10.5,0,0,0,2
8341,224.25,733,449,284,0.369
8342,251.25,663,432,231,0.473
8343,285.25,673,423,250,0.481
8344,260,700,449,251,0.402
8345,14.25,0,0,0,2
8346,237.75,664,436,228,0.464
8347,268.5,678,428,250,0.466
8348,45.75,3,2,1,1.993
8349,253.25,666,428,238,0.478
8350,268.25,695,448,247,0.409
8351,286,679,435,244,0.451
8352,11.5,0,0,0,2
8353,48.5,1,0,1,1.999
8354,237,665,418,247,0.499
8355,8.25,0,0,0,2
8356,6.5,0,0,0,2
8357,206.75,665,426,239,0.483
8358,313,669,427,242,0.477
8359,8.25,0,0,0,2
8360,327.25,700,447,253,0.406
8361,27.25,0,0,0,2
8362,7,0,0,0,2
8363,34.25,1,0,1,1.999
8364,252.75,677,441,236,0.441
8365,268.5,681,436,245,0.447
8366,284,701,436,265,0.427
8367,283.5,677,428,249,0.467
8368,17,0,0,0,2
8369,359,650,434,216,0.482
8370,309.25,683,437,246,0.443
8371,244,683,431,252,0.455
8372,188,688,429,259,0.454
8373,233.75,652,426,226,0.496
8374,331.25,662,429,233,0.48
8375,248.5,689,434,255,0.443
8376,40.25,1,1,0,1.997
8377,13.5,0,0,0,2
8378,5.25,0,0,0,2
8379,248.5,698,442,256,0.418
8380,5.25,0,0,0,2
8381,233.5,627,414,213,0.545
8382,231,654,418,236,0.51
8383,29,0,0,0,2
8384,252,696,436,260,0.432
8385,11,0,0,0,2
8386,9.5,0,0,0,2
8387,19,1,1,0,1.997
8388,348.5,687,436,251,0.441
8389,210.25,691,440,251,0.429
8390,223,714,445,269,0.396
8391,21,1,0,1,1.999
8392,265.5,644,414,230,0.528
8393,238.25,670,428,242,0.474
8394,15.25,0,0,0,2
8395,298.5,694,447,247,0.412
8396,279.25,717,447,270,0.389
8397,11.75,0,0,0,2
8398,19.25,0,0,0,2
8399,305,718,450,268,0.382
8400,392,710,439,271,0.412
8401,303,702,448,254,0.402
8402,311.25,681,444,237,0.431
8403,299.25,677,434,243,0.455
8404,216.5,711,440,271,0.409
8405,14.75,0,0,0,2
8406,7.5,0,0,0,2
8407,6.75,0,0,0,2
8408,308.5,694,437,257,0.432
8409,251.5,667,430,237,0.473
8410,321.5,665,434,231,0.467
8411,312.75,676,432,244,0.46
8412,5.25,0,0,0,2
8413,26.25,1,0,1,1.999
8414,195.25,654,425,229,0.496
8415,292.5,646,421,225,0.512
8416,240.5,668,440,228,0.452
8417,67.25,2,1,1,1.996
8418,278.25,703,436,267,0.425
8419,8.5,0,0,0,2
8420,16,1,1,0,1.997
8421,17,0,0,0,2
8422,260,659,422,237,0.497
8423,263,644,413,231,0.53
8424,9,0,0,0,2
8425,23,1,1,0,1.997
8426,271.25,645,437,208,0.481
8427,2.5,0,0,0,2
8428,255.25,677,440,237,0.443
8429,226,658,434,224,0.474
8430,9.25,0,0,0,2
8431,96.75,2,2,0,1.994
8432,241.25,694,452,242,0.402
8433,6,0,0,0,2
8434,240.25,681,442,239,0.435
8435,259.5,674,430,244,0.466
8436,307.75,693,433,260,0.441
8437,275.5,688,445,243,0.422
8438,207.75,661,423,238,0.493
8439,23.25,1,1,0,1.997
8440,273.75,686,432,254,0.45
8441,43.75,8,6,2,1.98
8442,322.5,666,426,240,0.482
8443,13.75,0,0,0,2
8444,221,701,440,261,0.419
8445,270.25,651,432,219,0.485
8446,256.75,657,425,232,0.493
8447,237.25,728,446,282,0.38
8448,16.5,0,0,0,2
8449,282.25,681,435,246,0.449
8450,315.25,651,418,233,0.513
8451,231.25,721,444,277,0.391
8452,268.5,687,430,257,0.453
8453,312,693,442,251,0.423
8454,6.75,0,0,0,2
8455,229.5,667,430,237,0.473
8456,23,0,0,0,2
8457,33.25,1,1,0,1.997
8458,252,673,425,248,0.477
8459,251.5,711,447,264,0.395
8460,52,1,1,0,1.997
8461,14.75,0,0,0,2
8462,240,674,439,235,0.448
8463,310,688,437,251,0.438
8464,260.75,709,439,270,0.413
8465,259.5,716,448,268,0.388
8466,11,0,0,0,2
8467,289,676,430,246,0.464
8468,29.25,0,0,0,2
8469,65.75,7,5,2,1.983
8470,276.5,639,425,214,0.511
8471,7.5,0,0,0,2
8472,13,0,0,0,2
8473,249.75,710,441,269,0.408
8474,36.75,0,0,0,2
8475,9,0,0,0,2
8476,25.5,0,0,0,2
8477,261.25,651,423,228,0.503
8478,224,662,427,235,0.484
8479,33.25,1,1,0,1.997
8480,6.25,0,0,0,2
8481,306.75,647,428,219,0.497
8482,8,0,0,0,2
8483,26.5,1,0,1,1.999
8484,197.5,695,437,258,0.431
8485,251.25,686,423,263,0.468
8486,14.5,0,0,0,2
8487,58.75,3,3,0,1.991
8488,321,687,441,246,0.431
8489,318.75,701,442,259,0.415
8490,230,669,420,249,0.491
8491,226.5,667,423,244,0.487
8492,228.75,668,440,228,0.452
8493,29.25,0,0,0,2
8494,245.5,695,429,266,0.447
8495,267.25,672,440,232,0.448
8496,230,665,425,240,0.485
8497,8.75,0,0,0,2
8498,256.5,663,432,231,0.473
8499,289.5,675,432,243,0.461
8500,264.75,704,434,270,0.428
8501,21.25,0,0,0,2
8502,246.5,673,433,240,0.461
8503,257,675,432,243,0.461
8504,35,3,1,2,1.995
8505,230.75,661,431,230,0.477
8506,227.25,674,445,229,0.436
8507,239,672,431,241,0.466
8508,324.25,643,425,218,0.507
8509,20.25,0,0,0,2
8510,302.25,666,427,239,0.48
8511,31.5,2,2,0,1.994
8512,18.5,0,0,0,2
8513,275,698,435,263,0.432
8514,7.25,0,0,0,2
8515,318.5,687,434,253,0.445
8516,288,689,440,249,0.431
8517,33.75,1,1,0,1.997
8518,26.75,1,1,0,1.997
8519,218.5,667,423,244,0.487
8520,263.5,655,421,234,0.503
8521,268.5,714,444,270,0.398
8522,15.5,1,1,0,1.997
8523,312,644,426,218,0.504
8524,219.5,683,432,251,0.453
8525,244.25,670,435,235,0.46
8526,271.25,662,419,243,0.5
8527,12.25,0,0,0,2
8528,253.25,712,441,271,0.406
8529,256.25,698,445,253,0.412
8530,267,686,436,250,0.442
8531,279.5,672,433,239,0.462
8532,247.75,690,440,250,0.43
8533,239.5,665,429,236,0.477
8534,231.75,693,418,275,0.471
8535,8.25,0,0,0,2
8536,283,659,436,223,0.469
8537,331.75,695,440,255,0.425
8538,281.5,668,428,240,0.476
8539,259,672,427,245,0.474
8540,219,736,461,275,0.342
8541,20.75,1,1,0,1.997
8542,268.75,670,426,244,0.478
8543,23.5,0,0,0,2
8544,265.75,681,438,243,0.443
8545,270,705,447,258,0.401
8546,346.75,641,411,230,0.537
8547,7.5,0,0,0,2
8548,13.75,0,0,0,2
8549,4.75,0,0,0,2
8550,233,713,438,275,0.411
8551,292.25,692,440,252,0.428
8552,243,677,434,243,0.455
8553,247,704,440,264,0.416
8554,9.5,0,0,0,2
8555,324.75,693,442,251,0.423
8556,228.25,708,435,273,0.422
8557,223.5,668,431,237,0.47
8558,269.75,654,427,227,0.492
8559,254,695,448,247,0.409
8560,254.75,654,413,241,0.52
8561,216.5,695,440,255,0.425
8562,290.5,668,429,239,0.474
8563,262.5,671,443,228,0.443
8564,364.75,699,434,265,0.433
8565,326.5,654,422,232,0.502
8566,23.5,0,0,0,2
8567,230.75,673,422,251,0.483
8568,290.25,687,435,252,0.443
8569,10.75,0,0,0,2
8570,348.5,690,447,243,0.416
8571,303.5,622,423,199,0.532
8572,281.75,735,444,291,0.377
8573,246.75,716,444,272,0.396
8574,60.5,8,7,1,1.978
8575,242.25,683,423,260,0.471
8576,315.75,665,412,253,0.511
8577,281,661,432,229,0.475
8578,14.75,0,0,0,2
8579,248,654,420,234,0.506
8580,13.5,0,0,0,2
8581,41.5,4,4,0,1.988
8582,279.25,673,418,255,0.491
8583,226.5,658,425,233,0.492
8584,285.25,733,455,278,0.357
8585,6,0,0,0,2
8586,268,677,429,248,0.465
8587,232.25,692,426,266,0.456
8588,284.5,701,429,272,0.441
8589,23,0,0,0,2
8590,217.5,664,417,247,0.502
8591,272.75,683,413,270,0.491
8592,235.5,684,437,247,0.442
8593,199,720,451,269,0.378
8594,257.25,695,441,254,0.423
8595,232.5,657,430,227,0.483
8596,221.5,700,436,264,0.428
8597,21.5,0,0,0,2
8598,251.5,690,444,246,0.422
8599,233,661,427,234,0.485
8600,331.25,649,430,219,0.491
8601,312,708,443,265,0.406
8602,11.5,0,0,0,2
8603,18,1,1,0,1.997
8604,268,688,423,265,0.466
8605,206.5,716,443,273,0.398
8606,301,659,411,248,0.519
8607,237.75,636,408,228,0.548
8608,285,687,424,263,0.465
8609,27.25,1,1,0,1.997
8610,20,0,0,0,2
8611,225,679,435,244,0.451
8612,288.5,686,434,252,0.446
8613,360,695,439,256,0.427
8614,349.75,665,420,245,0.495
8615,15.5,0,0,0,2
8616,247.25,672,427,245,0.474
8617,30.75,0,0,0,2
8618,356.75,621,418,203,0.543
8619,29.75,0,0,0,2
8620,287.75,712,450,262,0.388
8621,238,672,419,253,0.49
8622,219.25,689,434,255,0.443
8623,270,720,452,268,0.376
8624,213.75,658,425,233,0.492
8625,228.5,679,436,243,0.449
8626,327.25,686,441,245,0.432
8627,234.5,664,436,228,0.464
8628,28.75,0,0,0,2
8629,5.25,0,0,0,2
8630,285.25,701,447,254,0.405
8631,10.75,0,0,0,2
8632,241.25,687,430,257,0.453
8633,276.25,669,447,222,0.437
8634,261.5,673,444,229,0.439
8635,269.75,666,416,250,0.502
8636,291,707,452,255,0.389
8637,214.25,699,445,254,0.411
8638,46.5,2,2,0,1.994
8639,280,725,444,281,0.387
8640,228.75,644,428,216,0.5
8641,347.75,690,449,241,0.412
8642,75,7,5,2,1.983
8643,243.5,688,438,250,0.436
8644,304,702,435,267,0.428
8645,234.5,701,436,265,0.427
8646,255.25,693,433,260,0.441
8647,22,0,0,0,2
8648,246.25,727,459,268,0.355
8649,244.25,721,449,272,0.381
8650,240.5,678,435,243,0.452
8651,8.25,0,0,0,2
8652,218,689,442,247,0.427
8653,229.5,613,396,217,0.595
8654,279.5,731,453,278,0.363
8655,268.5,689,426,263,0.459
8656,285,714,446,268,0.394
8657,288,695,435,260,0.435
8658,271.75,690,440,250,0.43
8659,305,732,458,274,0.352
8660,345.5,666,424,242,0.486
8661,35.75,1,0,1,1.999
8662,270.5,662,418,244,0.502
8663,212.75,676,441,235,0.442
8664,280.5,681,438,243,0.443
8665,260.25,720,451,269,0.378
8666,270,650,426,224,0.498
8667,340.25,681,443,238,0.433
8668,314.5,727,449,278,0.375
8669,44,3,2,1,1.993
8670,227,668,446,222,0.44
8671,17.25,0,0,0,2
8672,225.75,657,431,226,0.481
8673,274,684,436,248,0.444
8674,275.25,702,435,267,0.428
8675,287.5,708,454,254,0.384
8676,10.75,0,0,0,2
8677,19.75,1,1,0,1.997
8678,293.75,705,450,255,0.395
8679,8.75,0,0,0,2
8680,233.5,683,447,236,0.423
8681,263,642,420,222,0.518
8682,280.75,712,451,261,0.386
8683,342.5,683,425,258,0.467
8684,210,668,433,235,0.466
8685,20.75,1,1,0,1.997
8686,257,731,458,273,0.353
8687,259,695,441,254,0.423
8688,263,692,433,259,0.442
8689,15.25,0,0,0,2
8690,268.25,666,432,234,0.47
8691,303,650,424,226,0.502
8692,34,4,3,1,1.99
8693,17.25,0,0,0,2
8694,231.5,682,434,248,0.45
8695,315.75,700,447,253,0.406
8696,6.25,0,0,0,2
8697,280,699,452,247,0.397
8698,248.25,680,443,237,0.434
8699,299.25,691,441,250,0.427
8700,258,739,445,294,0.371
8701,9.5,0,0,0,2
8702,243.5,675,431,244,0.463
8703,11.75,0,0,0,2
8704,17.5,0,0,0,2
8705,281.25,608,409,199,0.574
8706,301.25,723,450,273,0.377
8707,16.25,0,0,0,2
8708,283.5,633,410,223,0.547
8709,21.75,1,0,1,1.999
8710,231.75,738,450,288,0.362
8711,272,670,422,248,0.486
8712,218.75,681,433,248,0.453
8713,3,0,0,0,2
8714,64.5,9,8,1,1.975
8715,238,649,424,225,0.503
8716,13.5,0,0,0,2
8717,3.75,0,0,0,2
8718,225,744,455,289,0.346
8719,346.25,710,444,266,0.402
8720,25,0,0,0,2
8721,8.25,0,0,0,2
8722,13,0,0,0,2
8723,275.25,669,433,236,0.465
8724,225.25,703,450,253,0.397
8725,318.75,637,419,218,0.525
8726,13.75,1,1,0,1.997
8727,232.5,685,438,247,0.439
8728,217.75,685,433,252,0.449
8729,287.5,680,433,247,0.454
8730,282.25,720,454,266,0.372
8731,227.5,692,438,254,0.432
8732,261.25,733,451,282,0.365
8733,306.5,667,428,239,0.477
8734,264,679,436,243,0.449
8735,289.5,694,433,261,0.44
8736,267.5,676,446,230,0.432
8737,298.75,678,431,247,0.46
8738,13.75,0,0,0,2
8739,238.5,694,439,255,0.428
8740,309.5,710,453,257,0.384
8741,40.25,3,2,1,1.993
8742,7.25,0,0,0,2
8743,16.75,0,0,0,2
8744,296.75,706,452,254,0.39
8745,282.5,690,437,253,0.436
8746,7.5,0,0,0,2
8747,295.75,619,410,209,0.561
8748,284.75,654,430,224,0.486
8749,215,688,446,242,0.42
8750,12,0,0,0,2
8751,11,0,0,0,2
8752,295.5,731,452,279,0.365
8753,249.75,612,407,205,0.574
8754,346.75,692,446,246,0.416
8755,212.75,699,440,259,0.421
8756,12.5,0,0,0,2
8757,232.25,699,455,244,0.391
8758,11,0,0,0,2
8759,43.5,2,1,1,1.996
8760,270.5,613,418,195,0.551
8761,286.25,703,448,255,0.401
8762,288.5,652,428,224,0.492
8763,257.25,632,414,218,0.54
8764,221.75,678,440,238,0.442
8765,299.25,668,436,232,0.46
8766,244,696,432,264,0.44
8767,314.75,670,429,241,0.472
8768,239,695,443,252,0.419
8769,19,0,0,0,2
8770,236.25,688,430,258,0.452
8771,245,684,433,251,0.45
8772,272.25,692,443,249,0.422
8773,46.75,1,1,0,1.997
8774,14.25,0,0,0,2
8775,340.25,671,440,231,0.449
8776,260.75,688,438,250,0.436
8777,306.75,661,418,243,0.503
8778,256.25,693,437,256,0.433
8779,291,665,429,236,0.477
8780,252.5,707,446,261,0.401
8781,329,685,433,252,0.449
8782,275.5,670,436,234,0.458
8783,14.75,0,0,0,2
8784,22.25,0,0,0,2
8785,266.5,711,450,261,0.389
8786,21.75,0,0,0,2
8787,287,719,442,277,0.397
8788,259,691,432,259,0.445
8789,248,639,419,220,0.523
8790,232.25,676,434,242,0.456
8791,59,9,6,3,1.979
8792,237.25,649,417,232,0.517
8793,23.5,1,0,1,1.999
8794,235.25,684,438,246,0.44
8795,244,682,439,243,0.44
8796,281.25,693,437,256,0.433
8797,301,699,434,265,0.433
8798,270.75,694,433,261,0.44
8799,267.75,673,432,241,0.463
8800,229.25,691,441,250,0.427
8801,13.25,0,0,0,2
8802,269.25,684,436,248,0.444
8803,232.25,647,420,227,0.513
8804,291.25,714,449,265,0.388
8805,231.75,718,447,271,0.388
8806,219.5,657,433,224,0.477
8807,281.25,630,415,215,0.54
8808,325,683,442,241,0.433
8809,234.5,666,430,236,0.474
8810,230.75,655,412,243,0.521
8811,257.75,664,434,230,0.468
8812,252.25,672,438,234,0.452
8813,300,681,442,239,0.435
8814,27.5,1,1,0,1.997
8815,320.25,683,421,262,0.475
8816,247,672,432,240,0.464
8817,249.75,678,437,241,0.448
8818,336.75,702,446,256,0.406
8819,334.5,647,424,223,0.505
8820,298.5,704,441,263,0.414
8821,270.5,686,441,245,0.432
8822,259,698,440,258,0.422
8823,17.5,1,0,1,1.999
8824,12,0,0,0,2
8825,24.25,0,0,0,2
8826,275.5,681,440,241,0.439
8827,323.25,695,443,252,0.419
8828,274.75,685,448,237,0.419
8829,303.75,720,446,274,0.388
8830,4.75,0,0,0,2
8831,224.25,715,442,273,0.401
8832,286.5,643,416,227,0.525
8833,10.5,0,0,0,2
8834,299,710,446,264,0.398
8835,251.5,690,438,252,0.434
8836,11.75,0,0,0,2
8837,234.25,663,435,228,0.467
8838,9,0,0,0,2
8839,237,688,440,248,0.432
8840,26.25,2,1,1,1.996
8841,259,672,426,246,0.476
8842,231.5,717,453,264,0.377
8843,308.75,696,438,258,0.428
8844,6.5,0,0,0,2
8845,14,0,0,0,2
8846,280,713,449,264,0.389
8847,262,680,433,247,0.454
8848,364,669,427,242,0.477
8849,262.25,665,438,227,0.459
8850,48,3,3,0,1.991
8851,33.75,0,0,0,2
8852,296,687,427,260,0.459
8853,265.5,657,418,239,0.507
8854,16.5,0,0,0,2
8855,15.75,0,0,0,2
8856,272.5,693,437,256,0.433
8857,16,0,0,0,2
8858,209,665,430,235,0.475
8859,276,722,455,267,0.368
8860,255.75,693,442,251,0.423
8861,17,1,1,0,1.997
8862,254,647,423,224,0.507
8863,12.5,0,0,0,2
8864,249.75,691,430,261,0.449
8865,56.25,9,8,1,1.975
8866,255,708,454,254,0.384
8867,279.75,733,453,280,0.361
8868,251.25,676,436,240,0.452
8869,26.5,2,0,2,1.998
8870,17,1,1,0,1.997
8871,249.5,725,454,271,0.367
8872,216.5,712,448,264,0.392
8873,242,670,433,237,0.464
8874,220.75,667,432,235,0.469
8875,219.5,652,430,222,0.488
8876,227.5,688,447,241,0.418
8877,245,644,415,229,0.526
8878,17.5,1,1,0,1.997
8879,349,653,421,232,0.505
8880,302.75,730,448,282,0.374
8881,8.5,0,0,0,2
8882,221.5,692,428,264,0.452
8883,269.75,704,450,254,0.396
8884,304,725,458,267,0.359
8885,268,642,422,220,0.514
8886,18.25,0,0,0,2
8887,250.75,634,421,213,0.524
8888,27.5,0,0,0,2
8889,253.5,688,452,236,0.408
8890,194.25,690,445,245,0.42
8891,239.75,672,433,239,0.462
8892,79,5,2,3,1.991
8893,283,686,442,244,0.43
8894,20.5,0,0,0,2
8895,286.5,685,435,250,0.445
8896,276.75,696,443,253,0.418
8897,308.5,714,453,261,0.38
8898,253.5,683,435,248,0.447
8899,304.5,643,423,220,0.511
8900,9.75,0,0,0,2
8901,7.5,0,0,0,2
8902,327.75,706,444,262,0.406
8903,257.25,672,433,239,0.462
8904,281,696,438,258,0.428
8905,262.5,679,430,249,0.461
8906,300.75,669,421,248,0.489
8907,16.25,0,0,0,2
8908,253.25,692,431,261,0.446
8909,257.25,775,465,310,0.295
8910,302,702,442,260,0.414
8911,269.5,693,442,251,0.423
8912,273,687,436,251,0.441
8913,253.75,629,424,205,0.523
8914,276.75,692,439,253,0.43
8915,253,607,408,199,0.577
8916,302,632,408,224,0.552
8917,318.75,678,423,255,0.476
8918,230.5,650,428,222,0.494
8919,303,673,432,241,0.463
8920,241.25,679,440,239,0.441
8921,351.25,683,425,258,0.467
8922,16.75,0,0,0,2
8923,316.25,695,439,256,0.427
8924,25,0,0,0,2
8925,11.5,0,0,0,2
8926,286,703,438,265,0.421
8927,235.5,700,446,254,0.408
8928,257.75,641,413,228,0.533
8929,222.5,652,412,240,0.524
8930,55,6,4,2,1.986
8931,323,642,420,222,0.518
8932,266,666,441,225,0.452
8933,69.25,3,3,0,1.991
8934,279.25,722,442,280,0.394
8935,14.25,0,0,0,2
8936,219.25,675,435,240,0.455
8937,254,675,442,233,0.441
8938,256.25,716,447,269,0.39
8939,259.75,690,434,256,0.442
8940,14,0,0,0,2
8941,9,0,0,0,2
8942,8.75,0,0,0,2
8943,260,648,411,237,0.53
8944,252.25,679,442,237,0.437
8945,31.5,1,1,0,1.997
8946,284,678,442,236,0.438
8947,256,703,442,261,0.413
8948,250,640,427,213,0.506
8949,290.75,701,438,263,0.423
8950,9.75,0,0,0,2
8951,214,717,447,270,0.389
8952,284.5,672,430,242,0.468
8953,273.75,698,457,241,0.388
8954,270.5,716,453,263,0.378
8955,280,721,441,280,0.397
8956,251.5,660,426,234,0.488
8957,128.5,21,16,5,1.947
8958,13.5,0,0,0,2
8959,266.75,715,448,267,0.389
8960,33.25,1,1,0,1.997
8961,256.5,710,454,256,0.382
8962,269.5,626,429,197,0.516
8963,16.75,1,0,1,1.999
8964,229.25,661,429,232,0.481
8965,258.75,710,452,258,0.386
8966,250,670,430,240,0.47
8967,251.5,664,436,228,0.464
8968,231,711,426,285,0.437
8969,4.25,0,0,0,2
8970,216.75,653,426,227,0.495
8971,29,1,1,0,1.997
8972,218.25,707,442,265,0.409
8973,241.5,696,439,257,0.426
8974,17.75,0,0,0,2
8975,214,695,447,248,0.411
8976,11.75,0,0,0,2
8977,19.75,2,1,1,1.996
8978,209.5,634,407,227,0.552
8979,52.75,4,3,1,1.99
8980,23.25,0,0,0,2
8981,228.25,715,448,267,0.389
8982,227.25,703,448,255,0.401
8983,18.5,0,0,0,2
8984,207.5,707,450,257,0.393
8985,239,673,437,236,0.453
8986,274.5,686,435,251,0.444
8987,14,0,0,0,2
8988,269.5,652,425,227,0.498
8989,52.75,2,1,1,1.996
8990,248.25,721,439,282,0.401
8991,231,720,447,273,0.386
8992,248,710,453,257,0.384
8993,286.75,693,431,262,0.445
8994,239,679,432,247,0.457
8995,9.25,0,0,0,2
8996,244.75,675,431,244,0.463
8997,234.5,714,447,267,0.392
8998,324.5,654,425,229,0.496
8999,5,0,0,0,2
9000,9.25,0,0,0,2
9001,11.25,0,0,0,2
9002,304.25,671,424,247,0.481
9003,252.75,667,434,233,0.465
9004,285,661,429,232,0.481
9005,335.75,687,438,249,0.437
9006,217.5,699,447,252,0.407
9007,260.75,642,409,233,0.54
9008,344.25,648,418,230,0.516
9009,322.5,701,432,269,0.435
9010,73.5,12,9,3,1.97
9011,330.75,632,420,212,0.528
9012,16.5,1,1,0,1.997
9013,277.25,664,428,236,0.48
9014,310.25,651,422,229,0.505
9015,11.75,0,0,0,2
9016,11,0,0,0,2
9017,242,665,422,243,0.491
9018,32.75,1,1,0,1.997
9019,45.75,5,4,1,1.987
9020,257.25,694,442,252,0.422
9021,14.5,0,0,0,2
9022,220,659,422,237,0.497
9023,264,673,430,243,0.467
9024,22.5,2,1,1,1.996
9025,232.25,628,414,214,0.544
9026,238.75,690,436,254,0.438
9027,27.75,0,0,0,2
9028,285.25,646,425,221,0.504
9029,301.75,755,451,304,0.343
9030,239.25,688,445,243,0.422
9031,332,676,426,250,0.472
9032,224.75,709,443,266,0.405
9033,17.5,1,1,0,1.997
9034,223,677,442,235,0.439
9035,223.75,691,434,257,0.441
9036,236,690,445,245,0.42
9037,23,0,0,0,2
9038,19.5,0,0,0,2
9039,216.25,685,449,236,0.417
9040,17.25,2,2,0,1.994
9041,8.5,0,0,0,2
9042,237.25,665,429,236,0.477
9043,260.25,645,411,234,0.533
9044,2.75,0,0,0,2
9045,240.25,687,438,249,0.437
9046,7,0,0,0,2
9047,236.25,683,421,262,0.475
9048,315.25,678,427,251,0.468
9049,255.25,668,428,240,0.476
9050,23.25,0,0,0,2
9051,14.25,0,0,0,2
9052,226,693,428,265,0.451
9053,224.75,698,446,252,0.41
9054,285.75,656,413,243,0.518
9055,258.25,732,461,271,0.346
9056,7.25,0,0,0,2
9057,276.5,689,447,242,0.417
9058,24.75,1,1,0,1.997
9059,228.25,699,444,255,0.413
9060,229.5,678,430,248,0.462
9061,241.5,699,450,249,0.401
9062,246,682,432,250,0.454
9063,241.75,705,441,264,0.413
9064,295.5,720,444,276,0.392
9065,292.75,713,451,262,0.385
9066,254,696,445,251,0.414
9067,236.5,662,439,223,0.46
9068,8.25,0,0,0,2
9069,242.5,624,424,200,0.528
9070,309.25,714,450,264,0.386
9071,13.75,0,0,0,2
9072,304.5,648,418,230,0.516
9073,8.75,0,0,0,2
9074,11.75,0,0,0,2
9075,243.25,653,414,239,0.519
9076,71,6,4,2,1.986
9077,10.75,1,0,1,1.999
9078,317.5,715,447,268,0.391
9079,279.75,664,440,224,0.456
9080,216,690,438,252,0.434
9081,261,707,446,261,0.401
9082,243.25,692,433,259,0.442
9083,348.5,720,446,274,0.388
9084,25.75,0,0,0,2
9085,247,662,424,238,0.49
9086,14,0,0,0,2
9087,24,0,0,0,2
9088,22.25,0,0,0,2
9089,14.5,1,1,0,1.997
9090,237,673,446,227,0.435
9091,276,694,434,260,0.438
9092,279,717,447,270,0.389
9093,316.5,638,424,214,0.514
9094,280.25,650,425,225,0.5
9095,235.75,697,439,258,0.425
9096,58.5,3,2,1,1.993
9097,281.5,709,452,257,0.387
9098,272.25,697,443,254,0.417
9099,301,692,440,252,0.428
9100,13.5,0,0,0,2
9101,13.75,0,0,0,2
9102,270.5,746,448,298,0.358
9103,211.5,743,451,292,0.355
9104,18.5,0,0,0,2
9105,329.75,674,424,250,0.478
9106,332.5,705,434,271,0.427
9107,257.75,692,438,254,0.432
9108,326.75,668,425,243,0.482
9109,238,711,439,272,0.411
9110,247.5,705,445,260,0.405
9111,44.5,3,3,0,1.991
9112,10,0,0,0,2
9113,230,741,446,295,0.367
9114,214.75,686,433,253,0.448
9115,325.5,687,436,251,0.441
9116,62.25,6,4,2,1.986
9117,236,689,437,252,0.437
9118,20.75,1,1,0,1.997
9119,312.75,711,449,262,0.391
9120,269.25,688,433,255,0.446
9121,279,687,440,247,0.433
9122,373.75,683,424,259,0.469
9123,2.75,0,0,0,2
9124,255,635,408,227,0.549
9125,26.25,1,1,0,1.997
9126,253.5,724,453,271,0.37
9127,8.75,0,0,0,2
9128,260.5,652,429,223,0.49
9129,19,0,0,0,2
9130,270,664,410,254,0.516
9131,12,0,0,0,2
9132,293.25,682,429,253,0.46
9133,308.25,690,443,247,0.424
9134,318,706,442,264,0.41
9135,33.5,2,2,0,1.994
9136,226,647,417,230,0.519
9137,332.5,691,446,245,0.417
9138,226.5,660,430,230,0.48
9139,31.25,0,0,0,2
9140,238,694,441,253,0.424
9141,233.75,652,420,232,0.508
9142,274.25,683,434,249,0.449
9143,230.75,701,451,250,0.397
9144,292.5,643,421,222,0.515
9145,254.25,702,439,263,0.42
9146,234.25,677,438,239,0.447
9147,233.5,724,458,266,0.36
9148,50,5,4,1,1.987
9149,294.75,694,432,262,0.442
9150,222.25,673,436,237,0.455
9151,303.75,666,430,236,0.474
9152,242.5,689,433,256,0.445
9153,15,0,0,0,2
9154,11,0,0,0,2
9155,268.25,680,440,240,0.44
9156,248.5,612,391,221,0.606
9157,219.75,685,441,244,0.433
9158,235,665,424,241,0.487
9159,244.75,663,434,229,0.469
9160,262.75,639,422,217,0.517
9161,327,641,407,234,0.545
9162,268.75,641,420,221,0.519
9163,176.25,667,425,242,0.483
9164,213.5,667,427,240,0.479
9165,9,0,0,0,2
9166,3.5,0,0,0,2
9167,10.75,0,0,0,2
9168,10,0,0,0,2
9169,40.75,2,1,1,1.996
9170,42.5,1,1,0,1.997
9171,7.75,0,0,0,2
9172,44.75,3,2,1,1.993
9173,239,694,446,248,0.414
9174,24.5,0,0,0,2
9175,52,1,1,0,1.997
9176,18.5,0,0,0,2
9177,285.5,728,444,284,0.384
9178,17,1,0,1,1.999
9179,286.25,705,434,271,0.427
9180,329.75,662,418,244,0.502
9181,10.5,0,0,0,2
9182,230.75,688,439,249,0.434
9183,284.25,688,440,248,0.432
9184,297.25,666,431,235,0.472
9185,301.5,664,430,234,0.476
9186,253.25,667,438,229,0.457
9187,20.5,1,1,0,1.997
9188,218,733,455,278,0.357
9189,22.25,0,0,0,2
9190,18.5,0,0,0,2
9191,292.25,679,437,242,0.447
9192,348,641,428,213,0.503
9193,252,693,447,246,0.413
9194,272.25,724,457,267,0.362
9195,14,0,0,0,2
9196,287.5,679,427,252,0.467
9197,310.5,690,440,250,0.43
9198,399.5,682,431,251,0.456
9199,11.5,0,0,0,2
9200,290.75,736,451,285,0.362
9201,262.25,644,420,224,0.516
9202,12.25,0,0,0,2
9203,259.75,711,448,263,0.393
9204,281.25,687,428,259,0.457
9205,330.25,695,444,251,0.417
9206,325,699,447,252,0.407
9207,259.25,674,434,240,0.458
9208,4.5,0,0,0,2
9209,311.25,673,429,244,0.469
9210,251.5,655,429,226,0.487
9211,229.25,681,435,246,0.449
9212,226.25,711,447,264,0.395
9213,216.25,670,441,229,0.448
9214,275.75,705,454,251,0.387
9215,16,0,0,0,2
9216,218.75,706,452,254,0.39
9217,192.75,586,393,193,0.628
9218,283.75,667,426,241,0.481
9219,450.25,699,442,257,0.417
9220,226.75,689,432,257,0.447
9221,7,0,0,0,2
9222,86.75,11,8,3,1.973
9223,5.5,0,0,0,2
9224,278.75,651,423,228,0.503
9225,335.25,679,435,244,0.451
9226,219.25,681,441,240,0.437
9227,232.25,613,406,207,0.575
9228,272,662,427,235,0.484
9229,273.75,716,449,267,0.386
9230,290.75,642,416,226,0.526
9231,281.75,698,446,252,0.41
9232,306.75,662,428,234,0.482
9233,276.75,654,423,231,0.5
9234,296.5,666,421,245,0.492
9235,225.75,635,411,224,0.543
9236,10,0,0,0,2
9237,236,683,430,253,0.457
9238,5.25,0,0,0,2
9239,305.25,652,419,233,0.51
9240,23,0,0,0,2
9241,252.25,679,434,245,0.453
9242,250.5,687,435,252,0.443
9243,53.75,6,6,0,1.982
9244,13.75,0,0,0,2
9245,330.25,722,448,274,0.382
9246,258.5,715,439,276,0.407
9247,16.5,0,0,0,2
9248,263.5,707,448,259,0.397
9249,217.75,666,434,232,0.466
9250,298,708,438,270,0.416
9251,13.5,0,0,0,2
9252,284.25,661,418,243,0.503
9253,286.25,693,442,251,0.423
9254,7.75,0,0,0,2
9255,4.25,0,0,0,2
9256,11.5,0,0,0,2
9257,284,687,436,251,0.441
9258,249.25,714,452,262,0.382
9259,284.5,684,445,239,0.426
9260,320.75,687,438,249,0.437
9261,10.25,0,0,0,2
9262,248.5,689,441,248,0.429
9263,264.5,605,411,194,0.573
9264,51.25,4,3,1,1.99
9265,242.5,704,451,253,0.394
9266,266.25,643,420,223,0.517
9267,285,674,433,241,0.46
9268,254,693,444,249,0.419
9269,322.75,673,434,239,0.459
9270,216.75,673,444,229,0.439
9271,257.5,745,463,282,0.329
9272,273.75,730,450,280,0.37
9273,263.5,735,453,282,0.359
9274,263,677,443,234,0.437
9275,13,0,0,0,2
9276,223,663,435,228,0.467
9277,266.75,685,427,258,0.461
9278,234.5,690,438,252,0.434
9279,12.25,0,0,0,2
9280,10.25,0,0,0,2
9281,256.75,690,434,256,0.442
9282,66.75,1,1,0,1.997
9283,251.75,671,440,231,0.449
9284,324,667,429,238,0.475
9285,231,673,435,238,0.457
9286,18,1,1,0,1.997
9287,29.5,0,0,0,2
9288,224.75,702,450,252,0.398
9289,260,712,446,266,0.396
9290,312.75,688,438,250,0.436
9291,222,689,440,249,0.431
9292,23.25,0,0,0,2
9293,285,673,438,235,0.451
9294,8.75,0,0,0,2
9295,251.25,711,453,258,0.383
9296,263,698,436,262,0.43
9297,16,0,0,0,2
9298,334,645,421,224,0.513
9299,223,673,429,244,0.469
9300,27.5,1,0,1,1.999
9301,12.25,0,0,0,2
9302,243.25,670,435,235,0.46
9303,237.25,669,434,235,0.463
9304,27,1,1,0,1.997
9305,252.25,704,441,263,0.414
9306,18.75,1,0,1,1.999
9307,17.25,0,0,0,2
9308,22.75,1,1,0,1.997
9309,13,0,0,0,2
9310,248.25,714,447,267,0.392
9311,14.75,0,0,0,2
9312,287,687,428,259,0.457
9313,13.75,0,0,0,2
9314,295,643,426,217,0.505
9315,376.75,633,415,218,0.537
9316,307.75,673,423,250,0.481
9317,17.25,0,0,0,2
9318,279.5,731,451,280,0.367
9319,302.25,632,413,219,0.542
9320,214.75,757,465,292,0.313
9321,325.5,739,461,278,0.339
9322,212,683,432,251,0.453
9323,17.5,0,0,0,2
9324,25,0,0,0,2
9325,256.75,685,431,254,0.453
9326,362.5,662,416,246,0.506
9327,270.25,626,406,220,0.562
9328,223.5,691,447,244,0.415
9329,22.25,0,0,0,2
9330,357.5,650,410,240,0.53
9331,206,685,432,253,0.451
9332,232,679,438,241,0.445
9333,209.25,696,439,257,0.426
9334,273.75,708,432,276,0.428
9335,253,657,419,238,0.505
9336,43.5,1,1,0,1.997
9337,21.25,1,1,0,1.997
9338,47,0,0,0,2
9339,25,1,1,0,1.997
9340,9,0,0,0,2
9341,38.25,5,5,0,1.985
9342,273.25,679,437,242,0.447
9343,25.75,0,0,0,2
9344,362,670,430,240,0.47
9345,258.75,693,438,255,0.431
9346,13.5,0,0,0,2
9347,240.5,708,444,264,0.404
9348,265.5,708,456,252,0.38
9349,11.5,0,0,0,2
9350,229.5,704,439,265,0.418
9351,265,675,430,245,0.465
9352,241.5,678,438,240,0.446
9353,264.25,665,426,239,0.483
9354,260,706,440,266,0.414
9355,263.5,666,429,237,0.476
9356,222.25,709,445,264,0.401
9357,29.5,3,1,2,1.995
9358,13.25,0,0,0,2
9359,252.5,693,435,258,0.437
9360,251.5,657,427,230,0.489
9361,303.75,712,451,261,0.386
9362,248,715,453,262,0.379
9363,20.75,0,0,0,2
9364,12.5,0,0,0,2
9365,289.5,709,450,259,0.391
9366,28.25,2,2,0,1.994
9367,210,668,428,240,0.476
9368,300,682,428,254,0.462
9369,10.25,0,0,0,2
9370,293.75,672,427,245,0.474
9371,5.5,0,0,0,2
9372,5.5,0,0,0,2
9373,284.5,673,424,249,0.479
9374,12,0,0,0,2
9375,211.5,682,450,232,0.418
9376,10.25,0,0,0,2
9377,365.25,651,413,238,0.523
9378,246.5,671,425,246,0.479
9379,218.5,675,433,242,0.459
9380,216,698,447,251,0.408
9381,263,702,451,251,0.396
9382,39.25,3,2,1,1.993
9383,346.5,664,434,230,0.468
9384,300.25,692,429,263,0.45
9385,25.75,0,0,0,2
9386,258,664,437,227,0.462
9387,32.25,0,0,0,2
9388,24.75,1,1,0,1.997
9389,282,707,442,265,0.409
9390,10.25,0,0,0,2
9391,41.75,3,3,0,1.991
9392,9.75,0,0,0,2
9393,240.75,664,423,241,0.49
9394,269,702,438,264,0.422
9395,18,0,0,0,2
9396,253,720,461,259,0.358
9397,301.75,673,435,238,0.457
9398,265.25,704,440,264,0.416
9399,226,685,443,242,0.429
9400,254.75,689,441,248,0.429
9401,236.25,713,447,266,0.393
9402,221.75,654,423,231,0.5
9403,6.75,0,0,0,2
9404,7,0,0,0,2
9405,292.75,647,426,221,0.501
9406,289,730,449,281,0.372
9407,20.25,0,0,0,2
9408,212.25,654,428,226,0.49
9409,259.75,678,437,241,0.448
9410,325,729,442,287,0.387
9411,228.5,695,434,261,0.437
9412,340,699,443,256,0.415
9413,269,660,424,236,0.492
9414,26,0,0,0,2
9415,10.5,0,0,0,2
9416,263.5,698,438,260,0.426
9417,221.5,684,445,239,0.426
9418,313.25,701,438,263,0.423
9419,81.75,7,4,3,1.985
9420,23.25,0,0,0,2
9421,49.75,2,2,0,1.994
9422,297.25,662,432,230,0.474
9423,340,686,433,253,0.448
9424,10,0,0,0,2
9425,10,0,0,0,2
9426,23.25,2,2,0,1.994
9427,251,683,431,252,0.455
9428,12.75,0,0,0,2
9429,300.5,676,444,232,0.436
9430,11.75,0,0,0,2
9431,236.5,666,431,235,0.472
9432,244,679,426,253,0.469
9433,247.5,666,423,243,0.488
9434,13.5,0,0,0,2
9435,31.25,1,0,1,1.999
9436,195.75,672,428,244,0.472
9437,269.75,695,424,271,0.457
9438,288.5,677,440,237,0.443
9439,261.75,682,440,242,0.438
9440,274.75,660,426,234,0.488
9441,322.25,669,429,240,0.473
9442,210.5,712,441,271,0.406
9443,33.5,3,3,0,1.991
9444,25.75,2,2,0,1.994
9445,318.25,669,428,241,0.475
9446,257,703,439,264,0.419
9447,111.5,9,5,4,1.981
9448,268,718,436,282,0.41
9449,319.75,687,439,248,0.435
9450,28.5,1,0,1,1.999
9451,12.5,0,0,0,2
9452,263.5,678,433,245,0.456
9453,247,647,412,235,0.529
9454,339,625,407,218,0.561
9455,20.25,1,1,0,1.997
9456,28,1,1,0,1.997
9457,214.25,634,417,217,0.532
9458,224.25,699,442,257,0.417
9459,240.5,719,450,269,0.381
9460,296.25,651,433,218,0.483
9461,297.5,645,417,228,0.521
9462,305.5,695,434,261,0.437
9463,18.5,1,1,0,1.997
9464,324.5,674,428,246,0.47
9465,261.5,678,435,243,0.452
9466,346.75,663,438,225,0.461
9467,285.25,648,421,227,0.51
9468,291.75,619,412,207,0.557
9469,236.75,705,448,257,0.399
9470,23.5,4,3,1,1.99
9471,249,672,437,235,0.454
9472,29,1,0,1,1.999
9473,277.75,655,431,224,0.483
9474,22.75,0,0,0,2
9475,258.75,699,441,258,0.419
9476,244.5,709,439,270,0.413
9477,303.25,698,446,252,0.41
9478,8.5,0,0,0,2
9479,230,690,434,256,0.442
9480,7.25,0,0,0,2
9481,223,755,460,295,0.325
9482,349.5,651,424,227,0.501
9483,254.5,691,450,241,0.409
9484,72,8,5,3,1.982
9485,265.25,721,448,273,0.383
9486,332,666,424,242,0.486
9487,6,0,0,0,2
9488,246,684,441,243,0.434
9489,320.5,687,431,256,0.451
9490,272,692,432,260,0.444
9491,19.5,1,1,0,1.997
9492,31,2,1,1,1.996
9493,321.25,673,424,249,0.479
9494,344.5,603,393,210,0.611
9495,276.25,643,418,225,0.521
9496,53.75,5,3,2,1.989
9497,22.5,2,2,0,1.994
9498,227.25,679,446,233,0.429
9499,279.5,694,439,255,0.428
9500,11,0,0,0,2
9501,215.5,687,444,243,0.425
9502,67,6,5,1,1.984
9503,309,692,443,249,0.422
9504,292,719,457,262,0.367
9505,15.75,1,1,0,1.997
9506,289.5,701,428,273,0.443
9507,13.25,1,0,1,1.999
9508,273.25,718,440,278,0.402
9509,280.75,697,442,255,0.419
9510,18.5,0,0,0,2
9511,241.25,730,450,280,0.37
9512,236.5,677,439,238,0.445
9513,51,3,2,1,1.993
9514,282.5,704,454,250,0.388
9515,16.5,0,0,0,2
9516,243,647,425,222,0.503
9517,299,675,438,237,0.449
9518,228.5,700,436,264,0.428
9519,308.25,664,427,237,0.482
9520,265.25,729,458,271,0.355
9521,258.25,681,429,252,0.461
9522,234.75,662,421,241,0.496
9523,273,682,434,248,0.45
9524,263.75,714,449,265,0.388
9525,250.75,645,419,226,0.517
9526,5.25,0,0,0,2
9527,258.5,640,410,230,0.54
9528,252.75,654,435,219,0.476
9529,54.5,3,3,0,1.991
9530,233.5,748,455,293,0.342
9531,206,680,441,239,0.438
9532,235.25,666,421,245,0.492
9533,245.75,690,442,248,0.426
9534,13.5,0,0,0,2
9535,271.75,675,430,245,0.465
9536,294.5,698,446,252,0.41
9537,308.75,662,436,226,0.466
9538,7.25,0,0,0,2
9539,6.75,0,0,0,2
9540,286,686,429,257,0.456
9541,291,718,454,264,0.374
9542,247.5,658,425,233,0.492
9543,14.5,0,0,0,2
9544,28,0,0,0,2
9545,10.25,0,0,0,2
9546,272.75,694,451,243,0.404
9547,257.5,660,421,239,0.498
9548,274,699,442,257,0.417
9549,281.75,651,426,225,0.497
9550,25.25,2,1,1,1.996
9551,11.25,0,0,0,2
9552,270,711,447,264,0.395
9553,256.75,686,438,248,0.438
9554,272.75,673,434,239,0.459
9555,309.25,687,449,238,0.415
9556,232,692,447,245,0.414
9557,254.25,669,432,237,0.467
9558,14,0,0,0,2
9559,7,0,0,0,2
9560,254.5,690,432,258,0.446
9561,258.5,654,428,226,0.49
9562,280.5,640,432,208,0.496
9563,215.5,710,456,254,0.378
9564,246.75,721,457,264,0.365
9565,29.25,3,3,0,1.991
9566,286.25,713,450,263,0.387
9567,21.75,1,1,0,1.997
9568,218.25,647,420,227,0.513
9569,253.75,656,430,226,0.484
9570,251.25,650,416,234,0.518
9571,282,703,440,263,0.417
9572,241.75,727,455,272,0.363
9573,265.25,699,435,264,0.431
9574,6.5,0,0,0,2
9575,325.75,694,432,262,0.442
9576,66.5,4,2,2,1.992
9577,254,688,442,246,0.428
9578,280.25,701,449,252,0.401
9579,255,677,438,239,0.447
9580,266.5,637,412,225,0.539
9581,8.5,0,0,0,2
9582,228.75,689,443,246,0.425
9583,3,0,0,0,2
9584,66,4,3,1,1.99
9585,224.75,659,430,229,0.481
9586,44.25,1,1,0,1.997
9587,28,2,2,0,1.994
9588,258,692,436,256,0.436
9589,245.75,673,433,240,0.461
9590,9.25,0,0,0,2
9591,227.25,674,441,233,0.444
9592,292.5,695,440,255,0.425
9593,290.25,712,447,265,0.394
9594,302,695,430,265,0.445
9595,9.25,0,0,0,2
9596,251.25,717,459,258,0.365
9597,15.5,1,1,0,1.997
9598,217,668,433,235,0.466
9599,280.25,654,426,228,0.494
9600,256,670,430,240,0.47
9601,227.75,715,450,265,0.385
9602,18.75,1,1,0,1.997
9603,243.25,685,440,245,0.435
9604,7.5,0,0,0,2
9605,253,734,457,277,0.352
9606,243.75,696,425,271,0.454
9607,9.75,0,0,0,2
9608,291.5,700,441,259,0.418
9609,39.25,1,1,0,1.997
9610,250.5,670,431,239,0.468
9611,268,714,437,277,0.412
9612,259.5,706,443,263,0.408
9613,333.5,742,469,273,0.32
9614,10,0,0,0,2
9615,293.25,712,457,255,0.374
9616,220.75,670,423,247,0.484
9617,231.25,696,430,266,0.444
9618,300,683,436,247,0.445
9619,258.75,699,443,256,0.415
9620,13.5,0,0,0,2
9621,317.5,673,425,248,0.477
9622,242.75,714,441,273,0.404
9623,250.25,684,434,250,0.448
9624,244.5,707,445,262,0.403
9625,287,705,440,265,0.415
9626,8.75,0,0,0,2
9627,275.5,722,441,281,0.396
9628,248,694,441,253,0.424
9629,20.75,0,0,0,2
9630,362,658,429,229,0.484
9631,236,709,446,263,0.399
9632,251.75,718,443,275,0.396
9633,265.75,689,439,250,0.433
9634,260.5,695,435,260,0.435
9635,20.75,0,0,0,2
9636,17.75,0,0,0,2
9637,255.5,642,418,224,0.522
9638,303.25,646,420,226,0.514
9639,354.75,653,421,232,0.505
9640,266.75,683,430,253,0.457
9641,241,685,439,246,0.437
9642,278,689,441,248,0.429
9643,266.5,697,446,251,0.411
9644,295,716,452,264,0.38
9645,39.25,1,1,0,1.997
9646,236.75,689,442,247,0.427
9647,8.75,0,0,0,2
9648,65.25,6,4,2,1.986
9649,281.25,686,446,240,0.422
9650,15,0,0,0,2
9651,6.5,0,0,0,2
9652,208.25,731,454,277,0.361
9653,215.5,657,421,236,0.501
9654,245,698,440,258,0.422
9655,286.5,671,440,231,0.449
9656,313.75,745,456,289,0.343
9657,8,0,0,0,2
9658,236.5,623,411,212,0.555
9659,15,0,0,0,2
9660,299.75,678,447,231,0.428
9661,248.5,631,414,217,0.541
9662,237.75,710,440,270,0.41
9663,239,707,448,259,0.397
9664,232.5,619,401,218,0.579
9665,316.25,691,433,258,0.443
9666,27,0,0,0,2
9667,26.75,1,1,0,1.997
9668,7.25,0,0,0,2
9669,241.25,719,445,274,0.391
9670,10.5,0,0,0,2
9671,220.5,704,444,260,0.408
9672,312.25,675,431,244,0.463
9673,251,709,448,261,0.395
9674,246.25,686,440,246,0.434
9675,230.5,694,436,258,0.434
9676,264.5,676,432,244,0.46
9677,47.25,4,3,1,1.99
9678,17.5,1,1,0,1.997
9679,5.75,0,0,0,2
9680,232.5,667,429,238,0.475
9681,204.75,651,422,229,0.505
9682,14,0,0,0,2
9683,272.25,663,421,242,0.495
9684,276.5,720,452,268,0.376
9685,297.75,688,442,246,0.428
9686,245.75,664,430,234,0.476
9687,262.5,680,437,243,0.446
9688,246.25,698,455,243,0.392
9689,282.25,685,440,245,0.435
9690,252,714,437,277,0.412
9691,273,701,439,262,0.421
9692,216.25,673,426,247,0.475
9693,13.75,1,0,1,1.999
9694,240.25,676,425,251,0.474
9695,15.75,2,2,0,1.994
9696,9.25,0,0,0,2
9697,242.75,655,433,222,0.479
9698,9,0,0,0,2
9699,300.75,676,427,249,0.47
9700,28.5,0,0,0,2
9701,269.25,655,433,222,0.479
9702,221,731,457,274,0.355
9703,309.75,703,448,255,0.401
9704,14,0,0,0,2
9705,23,0,0,0,2
9706,13.5,0,0,0,2
9707,256.75,653,416,237,0.515
9708,322.75,691,445,246,0.419
9709,288,680,439,241,0.442
9710,282,659,440,219,0.461
9711,294.75,717,442,275,0.399
9712,20.5,0,0,0,2
9713,337.25,697,445,252,0.413
9714,6,0,0,0,2
9715,257.5,705,440,265,0.415
9716,274,691,436,255,0.437
9717,10.5,0,0,0,2
9718,30.75,1,0,1,1.999
9719,206.25,676,429,247,0.466
9720,262.5,699,443,256,0.415
9721,16.5,0,0,0,2
9722,16.25,0,0,0,2
9723,39,3,2,1,1.993
9724,311.5,695,441,254,0.423
9725,5,0,0,0,2
9726,5,0,0,0,2
9727,8.75,0,0,0,2
9728,259,642,418,224,0.522
9729,265.5,673,429,244,0.469
9730,22,1,1,0,1.997
9731,240.25,709,441,268,0.409
9732,24.25,3,2,1,1.993
9733,9.75,0,0,0,2
9734,254,703,438,265,0.421
9735,247.25,671,431,240,0.467
9736,21.75,1,1,0,1.997
9737,20.5,0,0,0,2
9738,259.5,658,428,230,0.486
9739,302.25,710,443,267,0.404
9740,38.75,1,1,0,1.997
9741,10.5,0,0,0,2
9742,264.25,697,435,262,0.433
9743,12.25,0,0,0,2
9744,11.75,1,1,0,1.997
9745,32.25,2,2,0,1.994
9746,279,714,459,255,0.368
9747,231.75,701,435,266,0.429
9748,26,0,0,0,2
9749,30.25,1,1,0,1.997
9750,240.5,652,429,223,0.49
9751,213.5,673,441,232,0.445
9752,23.25,1,0,1,1.999
9753,16,0,0,0,2
9754,52,2,2,0,1.994
9755,17.75,0,0,0,2
9756,49.75,6,4,2,1.986
9757,246.75,690,444,246,0.422
9758,244.75,683,433,250,0.451
9759,248.75,708,438,270,0.416
9760,8.75,0,0,0,2
9761,21.25,0,0,0,2
9762,26.5,0,0,0,2
9763,210.5,651,435,216,0.479
9764,12,0,0,0,2
9765,356,676,436,240,0.452
9766,281.75,698,441,257,0.42
9767,26.75,0,0,0,2
9768,206,678,434,244,0.454
9769,274.25,702,448,254,0.402
9770,13.75,1,1,0,1.997
9771,13,0,0,0,2
9772,5.25,0,0,0,2
9773,331.25,721,440,281,0.399
9774,366,691,427,264,0.455
9775,245.75,664,420,244,0.496
9776,15.25,0,0,0,2
9777,20.75,0,0,0,2
9778,229,665,442,223,0.451
9779,30,1,0,1,1.999
9780,396.75,715,447,268,0.391
9781,251.25,677,437,240,0.449
9782,226.25,651,413,238,0.523
9783,292,705,444,261,0.407
9784,327.25,627,407,220,0.559
9785,347.5,692,441,251,0.426
9786,207.75,690,448,242,0.414
9787,17.5,0,0,0,2
9788,11,0,0,0,2
9789,267.25,698,442,256,0.418
9790,38,2,2,0,1.994
9791,297.5,677,440,237,0.443
9792,272.75,705,441,264,0.413
9793,238.75,685,426,259,0.463
9794,290.25,680,429,251,0.462
9795,227.25,683,434,249,0.449
9796,280.5,726,455,271,0.364
9797,15.75,0,0,0,2
9798,235,671,434,237,0.461
9799,219,680,427,253,0.466
9800,219.75,669,437,232,0.457
9801,18.25,0,0,0,2
9802,16.25,0,0,0,2
9803,28.75,1,0,1,1.999
9804,211.25,686,449,237,0.416
9805,56.25,3,2,1,1.993
9806,11.5,0,0,0,2
9807,282.25,687,441,246,0.431
9808,241.5,677,442,235,0.439
9809,302.75,729,449,280,0.373
9810,22.5,0,0,0,2
9811,206.25,656,431,225,0.482
9812,239.25,656,422,234,0.5
9813,213,713,445,268,0.397
9814,246.5,694,429,265,0.448
9815,105,5,4,1,1.987
9816,284.5,715,444,271,0.397
9817,253.75,681,426,255,0.467
9818,237.75,645,430,215,0.495
9819,231.5,684,443,241,0.43
9820,268,651,425,226,0.499
9821,197.25,715,447,268,0.391
9822,15,0,0,0,2
9823,266.75,677,436,241,0.451
9824,276.25,617,411,206,0.561
9825,213,676,434,242,0.456
9826,288,711,454,257,0.381
9827,254,663,424,239,0.489
9828,299.5,685,431,254,0.453
9829,225,737,465,272,0.333
9830,289.5,670,433,237,0.464
9831,221.5,688,441,247,0.43
9832,235.75,663,428,235,0.481
9833,299.25,683,422,261,0.473
9834,20.25,0,0,0,2
9835,19.25,1,0,1,1.999
9836,238.5,658,416,242,0.51
9837,7,0,0,0,2
9838,269.5,658,432,226,0.478
9839,268.5,662,421,241,0.496
9840,11.25,0,0,0,2
9841,274.5,660,433,227,0.474
9842,311.5,676,420,256,0.484
9843,263,664,440,224,0.456
9844,274.25,661,439,222,0.461
9845,243.25,683,439,244,0.439
9846,38.25,2,2,0,1.994
9847,231,677,437,240,0.449
9848,254.5,694,442,252,0.422
9849,279,661,433,228,0.473
9850,284.25,723,457,266,0.363
9851,233.75,656,422,234,0.5
9852,13.25,0,0,0,2
9853,23.75,0,0,0,2
9854,246.5,681,442,239,0.435
9855,262.25,653,425,228,0.497
9856,34.25,2,2,0,1.994
9857,220.5,733,461,272,0.345
9858,287,702,438,264,0.422
9859,273.75,642,426,216,0.506
9860,228.5,653,417,236,0.513
9861,16,0,0,0,2
9862,15.75,1,1,0,1.997
9863,277,664,421,243,0.494
9864,17.5,0,0,0,2
9865,294.75,676,448,228,0.428
9866,9.5,0,0,0,2
9867,6.75,0,0,0,2
9868,261.75,655,420,235,0.505
9869,331.5,657,428,229,0.487
9870,13.25,0,0,0,2
9871,253,706,439,267,0.416
9872,264.75,688,437,251,0.438
9873,212.25,660,429,231,0.482
9874,22.75,1,0,1,1.999
9875,231.25,654,416,238,0.514
9876,259,662,427,235,0.484
9877,318,699,442,257,0.417
9878,246.25,651,426,225,0.497
9879,250.25,675,420,255,0.485
9880,12.75,0,0,0,2
9881,276.25,706,436,270,0.422
9882,251,737,450,287,0.363
9883,245,697,439,258,0.425
9884,278.75,686,442,244,0.43
9885,13.75,0,0,0,2
9886,308.5,651,424,227,0.501
9887,18,0,0,0,2
9888,22,3,2,1,1.993
9889,281.75,694,439,255,0.428
9890,311.25,665,434,231,0.467
9891,3.75,0,0,0,2
9892,217.75,678,430,248,0.462
9893,280.75,657,426,231,0.491
9894,269,695,436,259,0.433
9895,237.5,688,441,247,0.43
9896,279.75,683,438,245,0.441
9897,10.75,0,0,0,2
9898,4,0,0,0,2
9899,307.75,705,447,258,0.401
9900,334.75,765,471,294,0.293
9901,17.75,0,0,0,2
9902,8.75,0,0,0,2
9903,226,648,427,221,0.498
9904,290,655,413,242,0.519
9905,22,0,0,0,2
9906,248.25,704,432,272,0.432
9907,247.25,672,441,231,0.446
9908,49,0,0,0,2
9909,12.5,0,0,0,2
9910,222.5,677,424,253,0.475
9911,7.5,0,0,0,2
9912,251,691,452,239,0.405
9913,13,0,0,0,2
9914,12.5,0,0,0,2
9915,252.75,718,439,279,0.404
9916,253.25,713,453,260,0.381
9917,316.75,660,434,226,0.472
9918,249.25,692,435,257,0.438
9919,17.5,1,1,0,1.997
9920,240,704,438,266,0.42
9921,9.25,0,0,0,2
9922,33.5,1,1,0,1.997
9923,235.5,649,416,233,0.519
9924,288.25,681,437,244,0.445
9925,223.75,690,444,246,0.422
9926,8.5,0,0,0,2
9927,276,648,408,240,0.536
9928,298,714,453,261,0.38
9929,253.75,687,440,247,0.433
9930,25,2,0,2,1.998
9931,249.25,686,438,248,0.438
9932,29.5,0,0,0,2
9933,256,695,443,252,0.419
9934,265.25,713,450,263,0.387
9935,302.25,670,427,243,0.476
9936,290.25,656,421,235,0.502
9937,31.75,1,0,1,1.999
9938,5.75,0,0,0,2
9939,36.75,6,2,4,1.99
9940,299.25,620,400,220,0.58
9941,250.75,685,442,243,0.431
9942,243,701,434,267,0.431
9943,211,687,441,246,0.431
9944,267.25,689,432,257,0.447
9945,8,0,0,0,2
9946,9,0,0,0,2
9947,11.75,0,0,0,2
9948,281,696,441,255,0.422
9949,292,687,438,249,0.437
9950,230.25,686,436,250,0.442
9951,243.5,674,441,233,0.444
9952,18,0,0,0,2
9953,259.5,634,408,226,0.55
9954,13.25,0,0,0,2
9955,269,684,433,251,0.45
9956,7.5,0,0,0,2
9957,289,686,431,255,0.452
9958,279.75,693,436,257,0.435
9959,340,681,442,239,0.435
9960,272.75,701,440,261,0.419
9961,265.5,668,438,230,0.456
9962,235.25,687,427,260,0.459
9963,242.5,687,439,248,0.435
9964,233.75,707,443,264,0.407
9965,23.75,0,0,0,2
9966,253.25,687,435,252,0.443
9967,264.25,682,426,256,0.466
9968,10.5,0,0,0,2
9969,282,686,437,249,0.44
9970,294,711,453,258,0.383
9971,255.5,608,414,194,0.564
9972,304.5,707,437,270,0.419
9973,224,677,425,252,0.473
9974,269.25,657,433,224,0.477
9975,208,683,443,240,0.431
9976,30.25,1,1,0,1.997
9977,14,0,0,0,2
9978,328.25,672,430,242,0.468
9979,299,660,422,238,0.496
9980,42.5,2,2,0,1.994
9981,218.5,670,427,243,0.476
9982,11,0,0,0,2
9983,264.25,690,425,265,0.46
9984,39.75,2,2,0,1.994
9985,281.75,675,437,238,0.451
9986,5.5,0,0,0,2
9987,14.25,0,0,0,2
9988,246.25,686,435,251,0.444
9989,243.75,740,449,291,0.362
9990,283.75,708,434,274,0.424
9991,13.5,0,0,0,2
9992,336,658,427,231,0.488
9993,3.75,0,0,0,2
9994,207,707,451,256,0.391
9995,30.75,0,0,0,2
9996,44.25,2,2,0,1.994
9997,213,624,405,219,0.566
9998,21.25,0,0,0,2
9999,17,0,0,0,2
